arif lokal malu hidup harmoni dalam pela gandong	AGAMA
renung nyepi kendali api dalam diri	AGAMA
konferensi ulama ri dorong poros islam jalan tengah	AGAMA
renung idul adha sembelih anak	AGAMA
dialog lintas iman persepsi budaya untuk hidup toleransi	AGAMA
momentum pupuk solidaritas saleh spiritual dan sosial ibadah kurban bangun semangat rela korban	AGAMA
bineka toleransi simbol masyarakat adab	AGAMA
tradisi khas ramadhan ngaminang di kampung muslim tua di bal liput lebaran 2017	AGAMA
semua baik tahan diri wapres masjid tebar toleransi dan satu	AGAMA
kuota haji waktu tunggu berangkat makin singkat	AGAMA
musabaqah al quran indonesia tunjuk islam cinta damai	AGAMA
kongres ulama perempuan bangun jejaring lawan radikalisme	AGAMA
raya paskah paus seru damai di jumlah kawasan	AGAMA
idul adha jemaah tuntas wajib haji	AGAMA
layan masa lebaran mereka jibaku lawan rindu mudik gesit 2018	AGAMA
raya waisak tingkat peran agama dalam negara	AGAMA
analisis politik puasa menang	AGAMA
sistem tanggal beda kalender islam dan kalender jawa	AGAMA
renung natal natal hikmat bagi kita liput natal 2018	AGAMA
tanwir muhammadiyah kerja sama untuk adil sosial	AGAMA
renung paskah bangkit adalah wujud adab cinta	AGAMA
renung idul fitri bangun ukhuwah pasca-idul fitri	AGAMA
renung waisak kokoh satu bangsa	AGAMA
renung hari raya idul fitri kata dan kita	AGAMA
renung paskah paskah momentum rekonsiliasi	AGAMA
raya paskah paus sikap layan hindar konflik	AGAMA
intoleransi bebas agama jamin konstitusi	AGAMA
renung nyepi agama minus rohani	AGAMA
pesan idul fitri islam dorong perdamaian-keadilan	AGAMA
raya paskah paus ajak umat bangkit hadir hidup	AGAMA
renung waisak cinta kasih jaga bineka	AGAMA
hari raya waisak jaga bineka dengan cinta kasih	AGAMA
agam nikmat indah rasa indonesia	AGAMA
kampung peunayong agam dan rukun ala aceh	AGAMA
renung idul adha 1438 h kurban untuk kuat kohesi sosial	AGAMA
ibadah haji hari ini jemaah wukuf di arafah	AGAMA
temu lintas agama raja salman apresiasi toleransi di indonesia liput khusus datang raja salman	AGAMA
mudik gratis tak lagi gantung nyawa di atas roda dua liput lebaran 2017	AGAMA
agam bangun jembatan rawat beda	AGAMA
paus seru damai kapolri puji toleransi antarumat - natal 2017	AGAMA
asi youth day 2017 ragam indonesia jadi kuat asia	AGAMA
ibadah haji mek siap sambut jemaah	AGAMA
rukun umat suluh agama wajib jaga optimisme	AGAMA
analisis politik ukir tiada akhir	AGAMA
agam lembar kain gandong satu beda	AGAMA
organisasi islam perlu sebar optimisme siar terus narasi bineka	AGAMA
natal 2017 benar perintah dalam hati kita	AGAMA
islam moderat cegah jadi konflik	AGAMA
mufakat yogyakarta masyarakat daulat atas segala soal	AGAMA
pesan natal 2018 beda itu aset bukan ancam liput natal 2018	AGAMA
raya natal sahaja di tengah bencana	AGAMA
bencana longsor luas tanah labil hambat evakuasi korban di nganjuk	BENCANA
tanah longsor bencana itu bahaya bukan untuk wisata	BENCANA
tabrak untun bus tabrak 8 kendara di puncak 4 orang tewas	BENCANA
celaka laut km mutiara sentosa bakar tiga tewas	BENCANA
tirai kabut lereng sindoro	BENCANA
musibah dieng juang manusia itu terbang lama	BENCANA
celaka helikopter evakuasi puing henti saat	BENCANA
manusia picu celaka jembatan cisomang masih baik	BENCANA
bakar kapal knkt fokus pada sistem listrik km zahro express	BENCANA
longsor timpa sekolah proyek turap di ciater tangerang selatan perlu audit	BENCANA
banjir ratus ribu warga di sumbar dampak	BENCANA
lumpur sidoarjo bubar bpls sisa masalah besar	BENCANA
lingkung ancam serius bakar lahan	BENCANA
ancam erupsi tunggu pesan batara	BENCANA
gunung agung empat bandara siap ambil alih	BENCANA
gunung agung mitigasi bencana masih lemah	BENCANA
gunung agung ungsi landa ketidakpastian	BENCANA
gunung agung magma desak ke muka kawah	BENCANA
ungsi percaya sang bethara sayang kami	BENCANA
cuaca ekstrem siklon dahlia ancam pulau jawa bagi barat	BENCANA
kapal tenggelam 63 orang hilang di danau toba	BENCANA
celaka paruh napas legoso ikut kubur	BENCANA
jembatan ambruk target beres belum lebaran	BENCANA
kapal tenggelam isak tangis di tepi danau toba	BENCANA
korban duga jebak di kapal	BENCANA
gempa lombok pusat ambil alih tangan bencana	BENCANA
gempa lombok distribusi logistik masih hambat	BENCANA
krisis makan dan obat	BENCANA
asap bayang asi games	BENCANA
bakar lahan masih jadi	BENCANA
tsunami selat sunda jejak bencana tak buat peka bencana selat sunda	BENCANA
data awal buka akhir november	BENCANA
sukarelawan selamat untuk semua musibah lion air	BENCANA
tabur bunga ayah sudah di surga	BENCANA
pascagempa sulteng jumlah lokasi usul kosong	BENCANA
bantu mulai alir kita duka	BENCANA
gempa-tsunami sulteng warga swadaya benah kampung kita duka	BENCANA
mitigasi bencana survei singkap misteri tsunami palu	BENCANA
gempa-tsunami sulteng huntara sederhana pun belum cukup	BENCANA
mitigasi antisipasi gempa besar	BENCANA
geologi waspada siklus gempa besar di selatan jawa	BENCANA
banjir saat landa ibu kota musim hujan belum capai puncak	BENCANA
29 023 warga ungsi 217 titik ungsi siap	BENCANA
gunung agung debu yang lumpuh bal	BENCANA
tragedi kosambi awas andal lapor	BENCANA
ungsi gunung agung lelah tak buat mereka serah	BENCANA
sektor pariwisata ancam status awas gunung agung pengaruh hadap ekonomi bal	BENCANA
gunung agung ajar mitigasi di atas truk	BENCANA
bencana pesawat minta waspada	BENCANA
bakar lahan sumber air mulai kurang	BENCANA
rusa lingkung masif ubah tata guna lahan belum atas	BENCANA
bencana lingkung bedono yang hapus dari peta	BENCANA
bencana alam 11 000 warga kabupaten bandung dampak banjir	BENCANA
gempa poso warga tinggal di tenda darurat	BENCANA
evakuasi korban kendala kabut helikopter basarnas tabrak tebing	BENCANA
celaka tabrak bus dan truk 10 tewas	BENCANA
bakar lahan presiden ingat kepala daerah	BENCANA
titik panas bakar picu buka lahan	BENCANA
gunung agung krisis belum lewat pantau intensif	BENCANA
bencana alam longsor ancam jabar dan jateng selatan	BENCANA
gunung agung magma 4 km dekat kawah	BENCANA
siaga banjir jelang desember siklon tropis kuat cuaca ekstrem tingkat di pulau jawa	BENCANA
longsor ponorogo evakuasi korban kendala cuaca	BENCANA
dua kam lift tidak fungsi hanya 60 persen kondisi baik	BENCANA
dampak banjir makin parah ulah manusia buruk daya dukung lingkung	BENCANA
celaka laut saat peduli itu tak bakar api	BENCANA
menhub minta maaf posko ante mortem buka untuk identifikasi 20 korban bakar	BENCANA
hutan dan lahan cegah bakar tanggung jawab semua	BENCANA
bencana alam longsor dan banjir masih langsung di jumlah daerah	BENCANA
gunung agung kubah lava bentuk di kawah	BENCANA
tragedi kosambi pabrik kantong izin dari polisi dan perintah	BENCANA
pabrik kembang api anak paksa cari nafkah	BENCANA
warga khawatir gempa besar susul karena panik tiga orang tewas	BENCANA
mitigasi bencana gempa tasikmalaya alarm bagi pulau jawa	BENCANA
gunung agung status awas gera magma deteksi	BENCANA
cegah bakar efektif banyak pihak libat	BENCANA
madam bakar terobos onak duri kelah dengan api	BENCANA
bahaya terus intai	BENCANA
banjir jakarta belum milik peta evakuasi	BENCANA
solidaritas sosial deja vu petaka semai empati	BENCANA
longsor reta baru muncul	BENCANA
banjir posisi rel ka akan tinggi	BENCANA
longsor susul antisipasi	BENCANA
hujan masih ancam	BENCANA
bakar lahan ancam kabut asap antisipasi	BENCANA
ratus daki jebak	BENCANA
gempa lombok tangan bencana belum lancar	BENCANA
gempa lombok rehabilitasi dan rekonstruksi target tuntas enam bulan	BENCANA
langgar desain kapal akibat fatal	BENCANA
korban hilang 200 orang	BENCANA
gunung api rapi status waspada warga belum perlu ungsi	BENCANA
gempa-tsunami sulteng bangun huni sementara kita bangkit	BENCANA
gempa-tsunami sulteng aktivitas kantor belum pulih kita duka	BENCANA
presiden segera cepat distribusi bantu kita duka	BENCANA
gempa-tsunami sulteng solidaritas demi selamat sama	BENCANA
petaka di pesisir teluk palu	BENCANA
evakuasi rekam suara di kokpit belum lacak	BENCANA
dapur umum sumber energi untuk evakuasi musibah lion air	BENCANA
waspada longsor dan cuaca ekstrem	BENCANA
longsor pematang siantar-parapat putus total	BENCANA
infrastruktur kota jalan raya gubeng surabaya ambles	BENCANA
tsunami tak prediksi bencana selat sunda	BENCANA
bencana selat sunda saat wisata ubah jadi duka	BENCANA
bakar hutan dan lahan perintah kerah semua sumber daya	BENCANA
gunung api gunung agung siaga warga mulai ungsi	BENCANA
mitigasi bencana sadar warga hadap gempa masih rendah	BENCANA
tragedi kosambi cermin buruk kelola pemda	BENCANA
korban gunung rapi maju kena mundur pun kena	BENCANA
siaga bakar mulai olah lahan tanpa bakar perlu selain patroli titik panas	BENCANA
bencana alam banjir di pulau bangka makin luas	BENCANA
gera tanah hujan kurang longsor masih peluang jadi	BENCANA
korban km zahro express lewat gigi dan aksesori mereka nali	BENCANA
presiden aman jalur logistik korban longsor temu	BENCANA
waspada angin puting beliung muncul bibit siklon tropis	BENCANA
zona tektonik selatan jawa makin aktif	BENCANA
gunung agung ungsi butuh jamin aman	BENCANA
gunung agung intensitas gempa makin sering	BENCANA
ungsi mau ungsi asal sareng sampi	BENCANA
bakar lahan masyarakat butuh solusi	BENCANA
celaka danau toba bangkai kapal belum bisa temu	BENCANA
erupsi rapi warga harap sadar bencana	BENCANA
banyak faktor sebab longsor	BENCANA
bencana longsor sergap tsunami tanah gunung lio	BENCANA
batang baja rang	BENCANA
kawasan puncak longsor susul antisipasi	BENCANA
bakar sadar semua pihak masih rendah	BENCANA
rangkai gempa	BENCANA
evakuasi kendala alat	BENCANA
bangun huni sementara	BENCANA
dana manusia kompas sumbang untuk korban gempa lombok	BENCANA
dampak gempa pegawai hotel dan restoran rumah	BENCANA
dana manusia kompas sumbang bagi korban gempa di lombok	BENCANA
bencana alam jepang juta warga evakuasi	BENCANA
alat tidak bisa deteksi	BENCANA
celaka pesawat dua rekomendasi knkt untuk lion air	BENCANA
budaya respons bencana	BENCANA
bencana intai	BENCANA
cari pesawat temu titik terang musibah lion air	BENCANA
cari kotak hitam sinyal ping yang beri harap	BENCANA
musibah lion air anomali indikator cepat udara	BENCANA
lingkung kota kota medan kepung banjir	BENCANA
perintah bentuk satgas kita duka	BENCANA
gempa-tsunami sulteng petaka saat tanah gulung di palu	BENCANA
dana manusia kompas sumbang gempa sulteng	BENCANA
solidaritas sama kita bisa	BENCANA
gempa-tsunami sulteng kota palu perlahan mulai bangkit kita duka	BENCANA
bencana alam 152 korban masih timbun kita bangkit	BENCANA
dana manusia kompas sumbang gempa sulteng	BENCANA
aman bangun investigasi total lantai ambrol di gedung bei	BENCANA
bencana longsor tanah retak 293 warga ungsi	BENCANA
rentan longsor di lereng wilis perlu upaya mitigasi bencana seluruh di jawa timur	BENCANA
bencana alam banjir bandang landa jumlah daerah	BENCANA
bakar lahan langkah sederhana lawan trauma	BENCANA
antisipasi bakar hujan kurang di tiga provinsi prioritas	BENCANA
nasib korban banjir gagal panen hingga kemah di depan rumah	BENCANA
banjir masih ancam cuaca ekstrem prediksi sampai maret	BENCANA
bencana ibu kota yang tak juga siap hadap banjir	BENCANA
tragedi lapar 20 juta orang ancam tewas	BENCANA
bencana jalur sumatera barat-riau masih putus	BENCANA
mitigasi bencana damai dengan alam naf tanpa serakah	BENCANA
longsor masih ancam 26 orang masih timbun	BENCANA
longsor ponorogo dalam kejap sanak saudara hilang	BENCANA
banjir terus luas 12 orang timbun longsor	BENCANA
ungsi gunung agung juang mimpi yang enggan kubur	BENCANA
gunung agung perintah optimistis pariwisata bal aman	BENCANA
bakar di cere lindung huni gedung lemah	BENCANA
gunung agung ungsi tambah jadi 134 299 orang	BENCANA
gunung agung bal ambil alih data ungsi	BENCANA
gunung agung sembur asap tipis presiden akan kunjung bal	BENCANA
gunung agung presiden selamat prioritas warga minta patuh	BENCANA
bencana gunung agung guru untuk semua	BENCANA
pariwisata promosi harus ikut mitigasi	BENCANA
gunung agung status bencana belum putus	BENCANA
longsor ponorogo tim sar belum temu korban	BENCANA
adaptasi bencana yang miskin bayar lebih	BENCANA
lumpur sidoarjo presiden bubar bpls untuk efektivitas	BENCANA
bencana ekologi masih ada reta di gunung wilis	BENCANA
korban tanah longsor mereka terus tunggu keluarga temu	BENCANA
etiopia tari bagi tanah yang haus	BENCANA
bakar tidak ada waktu untuk menang	BENCANA
bencana alam longsor di kintamani telan 12 korban jiwa	BENCANA
sistem ingat dini minim rentan tingkat bencana luas	BENCANA
27 orang tewas timbun gera tanah telah muncul 20 hari lalu	BENCANA
bencana masih ancam mitigasi belum jadi budaya sama	BENCANA
bencana pacitan porak poranda akibat cempaka	BENCANA
bencana alam 300 lebih tewas akibat gempa iran	BENCANA
tragedi di kosambi 47 tewas bagi remaja	BENCANA
bakar bak air itu selamat kami	BENCANA
gunung agung nestapa malam di ungsi	BENCANA
gunung agung warga minim informasi baru	BENCANA
evaluasi angkut seberang	BENCANA
dampak gempa pariwisata lombok masih puruk	BENCANA
lombok landa gempa lagi	BENCANA
gempa lombok evakuasi rampung tim sisir jalur daki	BENCANA
bencana alam momentum tata pantai	BENCANA
ledak sumur minyak tak ada uang nila nyawa	BENCANA
ledak sumur minyak tutup dan usut sumur ilegal	BENCANA
area yang cemar minyak luas	BENCANA
gempa-tsunami sulteng belum ada tenda untuk sekolah kita bangkit	BENCANA
lindu ingat untuk jawa dan bal	BENCANA
gempa-tsunami sulteng warga palu masih sulit air bersih kita bangkit	BENCANA
gempa-tsunami sulteng fasilitas sehat mulai aktif kita duka	BENCANA
presiden evakuasi paling penting kita duka	BENCANA
gempa-tsunami sulteng kisah setia di tengah batas	BENCANA
air waduk terus susut	BENCANA
musibah lion air data kotak hitam mulai analis	BENCANA
bencana alam banjir mulai landa jumlah wilayah	BENCANA
celaka saksi drama tiga orang tinggal	BENCANA
kisah selam saya hanya bisa menang di dalam air	BENCANA
gempa-tsunami sulteng dapur yang cerita	BENCANA
kerja sama lanjut musibah lion air	BENCANA
musibah lion air jibaku sama dalam misi cari	BENCANA
jalur sumbar-riau truk belum izin lewat	BENCANA
tanah ambles pulih jalan gubeng tanpa libur	BENCANA
warga pulau evakuasi bencana selat sunda	BENCANA
bencana selat sunda tetap bagi dalam batas	BENCANA
banjir di india puluh ribu warga masih perangkap	BENCANA
produksi listrik mulai ganggu	BENCANA
bakar hutan panglima jamin asi games bebas asap	BENCANA
gempa lombok masa tanggap darurat panjang	BENCANA
tangan bencana sanitasi masih masalah	BENCANA
kering produksi dampak perlu ada antisipasi	BENCANA
bencana gempa untun landa lombok	BENCANA
celaka lalu lintas jalur maut sukabumi tewas 21 orang	BENCANA
bencana alam potensi letus gunung agung masih tinggi	BENCANA
relokasi warga kendala bencana selat sunda	BENCANA
pulih trauma hapus duka sintas bencana	BENCANA
tanah ambles jalan raya gubeng tuntas belum ganti tahun	BENCANA
kita duka	BENCANA
kerja sukarelawan masak demi manusia	BENCANA
gempa-tsunami sulteng rekonstruksi harap segera mulai kita bangkit	BENCANA
atur layar abai di toba	BENCANA
km sinar bangun benda duga kapal amat	BENCANA
gelombang tinggi warga panik lari ke bukit	BENCANA
evakuasi terus lanjut	BENCANA
bencana alam rasa gempa pada 3 726 mdpl	BENCANA
bakar lahan armada bom air belum optimal	BENCANA
mitigasi bencana waspada pada gempa susul	BENCANA
giat ajar desak segera mulai	BENCANA
awas lemah 18 orang tewas	BENCANA
publikasi riset kaji ilmiah tidak bisa pidana	BENCANA
infrastruktur semua jembatan tua perlu evaluasi dan audit	BENCANA
celaka lalu lintas 27 tewas polisi dalam tragedi subang	BENCANA
bencana alam waspada di brebes perlu tingkat	BENCANA
banjir pantura hambat lalu lintas ka	BENCANA
bencana alam perintah wacana relokasi rumah warga	BENCANA
tangan pascabencana pulih infrastruktur target tiga bulan	BENCANA
gunung agung ungsi zona aman akan pulang	BENCANA
solidaritas selamat korban gempa besar hantam meksiko ratus orang tewas	BENCANA
gunung api ada 20 gunung api tingkat aktivitas	BENCANA
tragedi danau toba warga pun bayar lebih mahal	BENCANA
gempa-tsunami sulteng baru 18 sekolah darurat siap kita bangkit	BENCANA
prioritas distribusi ke daerah isolasi kita duka	BENCANA
sukarelawan bencana demi manusia mereka datang	BENCANA
navigasi udara mitigasi bencana terbang susun kagama	BENCANA
gempa-tsunami sulteng lahan relokasi korban siap kita bangkit	BENCANA
mitigasi bencana frekuensi gempa bumi tingkat	BENCANA
di balik jatuh pesawat baru	BENCANA
area cari bisa luas musibah lion air	BENCANA
duka dalam di karawang musibah lion air	BENCANA
musibah lion air jam awal di lokasi serpih	BENCANA
bencana terus jadi	BENCANA
tanah ambles baik jalan minimal lima hari	BENCANA
area pelosok minim bantu bencana selat sunda	BENCANA
mitigasi bencana ingat awal krakatau	BENCANA
kuasa aset untuk tekan senjang bangun sisa soal	EKONOMI
laut china selatan capai penting asean dan china	EKONOMI
internasional hubung ekonomi indonesia-jepang makin baik	EKONOMI
kalang bisnis optimistis selesai bangun infrastruktur jadi tentu	EKONOMI
kunjung negara kerja sama ekonomi tingkat	EKONOMI
ktt iora basis kerja sama yang kokoh di kawasan telah bentuk	EKONOMI
harap dari beranda indonesia jelajah tapal batas	EKONOMI
apec sepakat ekonomi inklusif presiden dorong digital ekonomi	EKONOMI
infrastruktur sumber biaya dalam negeri batas tuju kompas100 ceo forum	EKONOMI
pisah politik dan ekonomi presiden ajak usaha untuk tidak tunggu - kompas100 ceo forum	EKONOMI
tumbuh ekonomi momentum pulih pada 2018 bisa jaga	EKONOMI
wawancara khusus cepat tumbuh yang adil	EKONOMI
tata ulang ekonomi jalur nontol di jawa	EKONOMI
analisis ekonomi ekonomi libur panjang lebaran	EKONOMI
jaga percaya hadap demokrasi 20 tahun reformasi	EKONOMI
asean-australia deklarasi sydney kuat mitra kawasan	EKONOMI
segera kelola talenta brilian	EKONOMI
analisis ekonomi kikis sumbat sektor riil	EKONOMI
ekonomi global pasar uang reaksi atas as-china	EKONOMI
adil sosial nasionalisme sempit bukan solusi	EKONOMI
ekonomi ketidakpastian ekonomi global lanjut	EKONOMI
makin berat dorong ekonomi	EKONOMI
diskusi ekonomi kompas cipta model tumbuh baru	EKONOMI
analisis ekonomi memitigasi jebak stagnasi	EKONOMI
miskin cipta ekonomi desa nila tambah	EKONOMI
bangun lanjut senjang jadi soal berat	EKONOMI
analisis ekonomi adu kuat program kerja	EKONOMI
paket bijak ekonomi perintah tarik modal asing	EKONOMI
sejahtera warga desa turun	EKONOMI
diskusi ekonomi kompas langkah jangka pendek kuat rupiah	EKONOMI
bawa dunia ke bal temu tahun imf-bank dunia bal 2018	EKONOMI
analisis ekonomi upah dan produktivitas	EKONOMI
analisis ekonomi cara lawan demagog populis	EKONOMI
konsumsi porsi dapat untuk belanja kurang	EKONOMI
bangun turun timpang lanjut	EKONOMI
ekonomi rakyat mimpi kabul dapur terus ngebul	EKONOMI
dana desa buka yang mandiri warga	EKONOMI
layan masyarakat profesionalitas bumd perlu jaga	EKONOMI
gotong royong kisah sukses jadi sarana replikasi koperasi	EKONOMI
pasar uang rekor baru ihsg jadi indikator positif	EKONOMI
analisis ekonomi tumbuh stagnan	EKONOMI
analisis ekonomi politik dagang kita	EKONOMI
analsis ekonomi kualitas tumbuh	EKONOMI
analisis ekonomi prospek ekonomi	EKONOMI
analisis ekonomi risiko global	EKONOMI
ekonomi jalur nontol kreativitas jadi kunci agar daerah tak mati	EKONOMI
analisis ekonomi tumbuh kualitas	EKONOMI
temu tahun imf-bank dunia 2018	EKONOMI
mereka ajar dari indonesia temu tahun imf-bank dunia bal 2018	EKONOMI
analisis ekonomi tak sekadar kais dollar	EKONOMI
mandiri kolaborasi kunci sukses desa	EKONOMI
analisis ekonomi kuat tahan ekonomi	EKONOMI
daya ekonomi desa	EKONOMI
indonesia kejar peluang kerja sama kawasan	EKONOMI
analisis ekonomi overdosis paket stimulus	EKONOMI
ekonomi defisit kian dalam rupiah rentan	EKONOMI
batas negara benah bangun bisa rawat semangat nasionalisme warga	EKONOMI
batas jibaku 14 jam demi butuh pokok	EKONOMI
investasi rp 4 1 triliun gerak kawasan ekonomi khusus mandalika	EKONOMI
bisnis harap tak ada gejolak	EKONOMI
nahdlatul ulama wujud arus baru ekonomi	EKONOMI
timpang bijak perata tengah matang	EKONOMI
timpang fungsi fiskal untuk perata bangun belum efektif	EKONOMI
analisis ekonomi bijak industri trump yang cacat	EKONOMI
rantau tonton sama bangun negeri	EKONOMI
dampak bangun jalan tol tahan dalam bising	EKONOMI
ekonomi indonesia harus waspada risiko global	EKONOMI
analisis ekonomi lambat beri kompensas	EKONOMI
cepat penuh janji reformasi 20 tahun reformasi	EKONOMI
ekonomi model tumbuh baru perlu	EKONOMI
bandara internasional jawa barat yang untung dan buntung dari bangun	EKONOMI
semenanjung korea korea utara beri harap baru	EKONOMI
ekonomi insentif bisa jadi sentimen positif bagi investor	EKONOMI
analisis ekonomi injak pedal rem	EKONOMI
bangun batas wajah laru kian seri	EKONOMI
ktt g-20 ada desa tata ulang sistem dagang	EKONOMI
analisis ekonomi badai agak reda	EKONOMI
indonesia upaya kuat diri temu tahun imf-bank dunia bal 2018	EKONOMI
lapor akhir tahun ekonomi tumbuh ekonomi yang tekan timpang	EKONOMI
ri di masa tentu bijak industrial penting untuk baik struktur ekonomi	EKONOMI
anggar bangun mobilisasi hambat soal struktural	EKONOMI
diskusi ekonomi kompas dalam bayang masalah struktural	EKONOMI
bijak ekonomi as usaha tunggu arah baru	EKONOMI
kawasan ekonomi khusus senyap megaproyek di kota cakalang jelajah terumbu karang	EKONOMI
analisis ekonomi tumbuh ekonomi tanpa industrialisasi	EKONOMI
sidang tahun mpr bangun daerah batas tahap jelajah tapal batas	EKONOMI
asean 50 buka dorong ekonomi asean 50 2017	EKONOMI
kerja sama internasional bank dunia kenal ri bagai tuju investasi	EKONOMI
potensi perlu optimal	EKONOMI
analisis ekonomi antisipasi perang dagang	EKONOMI
kerja sama bilateral mitra strategis kuat ri-india	EKONOMI
target 5 4 persen di 2018 rekor ihsg di 6 025 jaga sentimen positif	EKONOMI
ktt asean indonesia dorong asean jadi progresif	EKONOMI
freeport tolak jumlah syarat perintah siap hadap arbitrase internasional	EKONOMI
indikator investasi dan ekspor tarik tumbuh ekonomi triwulan i	EKONOMI
asean harus beri efek positif perang di semenanjung korea sengsara	EKONOMI
hut emas asean transformasi-relevansi	EKONOMI
bp batam ganti pimpin upaya bangkit kek	EKONOMI
diplomasi hubung korut dan korsel kian mesra	EKONOMI
analisis ekonomi perang yang sia	EKONOMI
konferensi tingkat tinggi indonesia dorong konsep indo-pasifik dunia	EKONOMI
infrastruktur tol trans-jawa segera sambung	EKONOMI
analisis ekonomi mitigasi ketidakpastian 2019	EKONOMI
ekonomi perintah bahas strategi hadap ketidakpastian	EKONOMI
jalan tol ruas ekonomi sumut kian kompetitif	EKONOMI
asean-india presiden harap wujud ekosistem damai	EKONOMI
avengers infinity war lalu game of thrones	EKONOMI
indonesia gugah dunia temu tahun imf-bank dunia bal 2018	EKONOMI
tumbuh ekonomi tantang makin kompleks	EKONOMI
kerja sama kawasan asean-australia tolak proteksionisme	EKONOMI
analis ekonomi hadap tahun ketidakpastian	EKONOMI
analisis ekonomi bela bagi populisme ekonomi	EKONOMI
diskusi ekonomi kompas optimistis serta inovasi	EKONOMI
balai ekonomi desa terang borobudur yang kini bagi	EKONOMI
diskusi ekonomi ekonomi ubah perlu sesuai	EKONOMI
kunjung raja salman susun 10 nota paham	EKONOMI
ekonomi devisa gerus ekspor akan genjot	EKONOMI
temu tahun imf-bank dunia pesan kolaborasi gaung dari bal temu tahun imf-bank dunia bal 2018	EKONOMI
imf daya tahan indonesia uji temu tahun imf-bank dunia bal 2018	EKONOMI
kerja sama kawasan temu apec gagal hasil sepakat	EKONOMI
ekonomi indonesia hadap dua fase pada 2019	EKONOMI
harga gas industri jumlah pakai gas terus turun	ENERGI
tambang ilegal sungai panjang itu kini makin rusak	ENERGI
nobel damai pesan kuat bagi negara milik senjata nuklir	ENERGI
infrastruktur presiden instruksi pasok listrik daerah jamin	ENERGI
energi baru manfaat biogas dari air limbah tahu	ENERGI
listrik kerlip asa warga karimunjawa	ENERGI
energi listrik harta karun di dalam kulkas tambora challenge	ENERGI
tata kelola tambang masalah	ENERGI
liput investigasi lumbung pangan pun ikut hancur	ENERGI
cegah proyek tak lanjut damping masyarakat perlu	ENERGI
energi baru halau gelap dari bangku sekolah	ENERGI
sumber daya alam tambang untuk makmur rakyat	ENERGI
tambang adat jaga tak silau oleh emas	ENERGI
aparat minta lebih tegas rakyat butuh legalitas izin	ENERGI
energi baru bangkit listrik tenaga bayu sidrap i siap operasi	ENERGI
bor ilegal perlu solusi bijak kait sumur minyak	ENERGI
bahan bakar minyak alokasi premium jadi 11 8 juta kiloliter	ENERGI
tambang batubara ilegal di bukit soeharto	ENERGI
energi baru nang di waengapan	ENERGI
stok bbm fokus untuk jalur mudik 90 sepeda motor siap jual bbm - mudik gesit	ENERGI
tambang dukung perintah tetap perlu	ENERGI
tambang ekspor mineral longgar	ENERGI
ketenagalistrikan proyek pltu di malu mangkrak	ENERGI
tambang ketidakpastian freeport kian tinggi	ENERGI
tambang freeport harus paham itikad perintah ri	ENERGI
tambang ilegal tambang emas poboya segera tutup	ENERGI
ri bayang krisis energi selisih pasok dan minta lebar	ENERGI
energi baru desa kamanggih lawan gulita	ENERGI
tambang divestasi freeport klaim beres	ENERGI
krisis energi malam gelap di tampur paloh	ENERGI
tambang pulau romang hati serasa iris dengar hila belah	ENERGI
tambang perintah hadap dilema	ENERGI
tambang perintah cari solusi untuk freeport	ENERGI
ketenagalistrikan atur baru cegah proyek mangkrak	ENERGI
tambang prioritas bumn beli saham freeport	ENERGI
aktivitas tambang ilegal kian marak rusa daerah makin masif	ENERGI
tambang batubara tambang di pulau laut tutup	ENERGI
energi baru target baur energi kira meleset	ENERGI
dampak ekonomi kais remah kue tambang	ENERGI
tambang cita hilir wujud	ENERGI
tambang program hilir belum integrasi	ENERGI
energi baru kembang perlu dukung daerah	ENERGI
panitia angket kerja kpk sengaja akan kacau	HUKUM
angket kpk ancam dpr tak pengaruh perintah	HUKUM
ruu milu inisiatif presiden kini nanti	HUKUM
dpr terus cari lemah kpk temu napi jadi upaya baru	HUKUM
narkotika oknum polisi duga kendali 44 kg sabu	HUKUM
hakim konstitusi kecewa rakyat proses hukum patrialis tunggu	HUKUM
diskusi kompas jaga semangat tega ham	HUKUM
malaysia usut asal racun vx akses konsuler oleh	HUKUM
zat maut vx	HUKUM
timpang reforma agraria dan akses modal jadi fokus	HUKUM
proyek ktp-el jadi bancak korupsi duga libat politis lintas partai	HUKUM
data duduk korupsi rusak program ktp-el	HUKUM
jangan halang langkah kpk korupsi jadi ancam besar	HUKUM
paedofilia jaring predator di grup permen	HUKUM
operasi tangkap tangan temu deposito ratus miliar rupiah	HUKUM
posisi politik golkar tak ubah setya novanto jadi sangka	HUKUM
lembaga antikorupsi selalu ganggu perintah jadi tentu	HUKUM
dpr tuju perppu revisi perppu ormas sah jadi uu	HUKUM
kasus novel jadi uji polisi sulit kumpul saksi dan alat bukti	HUKUM
novel kpk harus usul bentuk tgpf	HUKUM
dpr ri sandera novanto masih kuasa	HUKUM
kuasa novanto hilang airlangga hartarto akan kukuh bagai ketua umum partai golkar	HUKUM
analisis politik politik korup	HUKUM
pres harus bicara dengan dewan	HUKUM
target rkuhp kembali mundur	HUKUM
berantas korupsi presiden ingat jabat negara	HUKUM
korupsi bayang serta pilkada	HUKUM
rp 6 4 triliun hasil narkoba	HUKUM
korupsi partai politik tidak ada terobos	HUKUM
metanol bahan bakar dan awet mayat	HUKUM
hukum tak buat jera	HUKUM
minum keras jadi lari	HUKUM
tolak terus galang	HUKUM
eksekusi masih pro dan kontra	HUKUM
ruu antiterorisme dpr janji revisi selesai mei	HUKUM
ruu kuhp beda dapat masih jadi	HUKUM
duga korupsi gubernur aceh tangkap kpk	HUKUM
berantas mafia bola hingga akar	HUKUM
kuat sistem dan awas	HUKUM
berantas korupsi bangun sistem butuh	HUKUM
usut tuntas rusa polsek	HUKUM
lembaga adil baik kultur belum jadi	HUKUM
asn korupsi cepat proses henti	HUKUM
malaysia penjara hingga akhir hayat nanti najib	HUKUM
turki-arab saudi erdogan bunuh khashoggi rencana amat teliti	HUKUM
rkuhp ancam demokrasi	HUKUM
novanto lihat sikap tidak puji warga ntt cabut dukung	HUKUM
novanto sangka kpk lapor kapolri cermat arah presiden	HUKUM
ganggu aman sabtu batas akhir sandera	HUKUM
bandar laku regenerasi candu sasar anak usia tk dan sd	HUKUM
reforma agraria cepat sertifikasi lahan rakyat	HUKUM
tutup celah korupsi dana desa manfaat sistem lapor	HUKUM
uu milu tumpu uji materi nanti	HUKUM
duga libat wni masih dalam wapres tak yakin sa intel korut	HUKUM
cuci uang pecat niwen butuh waktu lama	HUKUM
isu aman bandara cuat tembak babi buta di florida 5 tewas	HUKUM
hari antinarkotika narkoba kian ancam masa depan bangsa	HUKUM
kasus novel baswedan polisi tahu identitas dua laku	HUKUM
narkoba jenis baru edar bebas regulasi lamban antisipasi	HUKUM
narkoba mereka yang jibaku tangkap laku	HUKUM
novel baswedan presiden perintah kapolri ungkap laku cepat	HUKUM
jahat siber produsen hoaks incar peristiwa politik	HUKUM
hakim korupsi karena tamak remunerasi sudah cukup	HUKUM
kuat koordinasi berantas korupsi kpk tak wenang soal densus	HUKUM
tembak texas trump geming soal pakai senjata api	HUKUM
kpk kembali sidik novanto ada usaha fiktif di ktp-el	HUKUM
novanto minta serah diri sidik kpk bawa surat tangkap	HUKUM
bunuh kemlu ri kirim tim verifikasi ke selangor	HUKUM
suap hakim mk patrialis laku langgar berat	HUKUM
tradisi keras terus biar 10 mahasiswa uii yogyakarta paksa rawat	HUKUM
keras pupus sudah cita asyam kuliah di oxford	HUKUM
putus mk koruptor makin sulit proses hukum	HUKUM
konsistensi fraksi tunggu hak angket ke kpk jadi preseden buruk tega hukum	HUKUM
jalan siti aisyah mimpi yang pupus saat mulai semi	HUKUM
perhati dukung publik ke kpk langkah presiden tunggu	HUKUM
duga korupsi kpk yakin tak hanya emirsyah yang suap	HUKUM
labuh ikan jalur narkoba penjara khusus bandar dan edar bangun di natuna	HUKUM
bala liar klhk siap operasi padu	HUKUM
jahat seksual sangka perkosa anak ringkus polisi	HUKUM
bumn jadi ladang korupsi biaya pasar jadi modus	HUKUM
saat novanto hilang hingga celaka	HUKUM
persekusi teror baru ancam bagi bangsa ada kosong hukum	HUKUM
psikologis trauma itu masih bekas dalam	HUKUM
presiden ikut proses hukum novanto jalan periksa ct-scan dan mri	HUKUM
potensi konflik mesti hindar polri sidik kasus yang libat pimpin kpk	HUKUM
korupsi ktp elektronik ketua kpk jangan coba hambat	HUKUM
korupsi pns pidana masih kerja di sulut	HUKUM
tembak di las vegas motif jahat masih jadi misteri	HUKUM
kriminalitas teripang nyaris habis curi	HUKUM
tindak korupsi ketua kpk - suap telah jadi biasa	HUKUM
dana desa sumber korupsi baru kpk tangkap bupati dan kajari pamekasan	HUKUM
khawatir yang nyata	HUKUM
indonesia darurat korupsi	HUKUM
ibarat kisah tak ujung	HUKUM
narkoba jenis baru terus tambah	HUKUM
jerat candu narkoba	HUKUM
demokrasi indonesia ancam	HUKUM
psikotropika 68 jenis narkoba edar	HUKUM
narkoba banjir indonesia	HUKUM
selundup goda suap duit narkoba di laut	HUKUM
indeks persepsi korupsi integritas tegak hukum jadi masalah	HUKUM
bunuh anak jadi korban konflik rumah tangga	HUKUM
korupsi di brasil eks presiden lula jalan hukum	HUKUM
setya novanto tinggal	HUKUM
rantas korupsi dana otonomi khusus jadi ladang korupsi	HUKUM
jalan liku irwandi	HUKUM
ruu kuhp mesti kawal	HUKUM
legislasi ruu antiterorisme segera sah	HUKUM
tuntut hadap najib siap	HUKUM
tega hukum kasus ham masih jadi beban sejarah 20 tahun reformasi	HUKUM
lembaga adil hakim di daerah keluh iur	HUKUM
reformasi birokrasi belum optimal	HUKUM
mafia anggar masih operasi	HUKUM
jahat siber produsen konten hoaks ungkap	HUKUM
korupsi adil sangka suap menang perkara	HUKUM
presiden tak tuju lemah kpk korupsi masih rajalela	HUKUM
kapolri densus tak ganggu kpk komitmen polri mesti bukti	HUKUM
yap thiam hien award gus mus rumah indonesia harus jaga sama	HUKUM
kpk ada sangka baru wapres novanto harus taat	HUKUM
bagi uang mulai kuak kpk saksi wajib bicara benar	HUKUM
panitia angket sikap presiden amat tentu	HUKUM
berantas korupsi lemah kpk terus cari	HUKUM
berantas korupsi kpk siap gelar lebih banyak ott	HUKUM
langkah malaysia rugi siti sidang dua siti aisyah jaksa belum siap aju dokumen	HUKUM
aparat razia tak henti satu keluarga tembak	HUKUM
suap rolls-royce emirsyah janji ungkap kasus	HUKUM
presiden bongkar korupsi ktp-el tak akan ada turbulensi politik	HUKUM
korea selatan oposisi desak park geun-hye tangkap	HUKUM
aksi klithih mereka sama jadi korban	HUKUM
korupsi ktp-el desa novanto mundur kuat	HUKUM
arab saudi drama politik pada sabtu malam di kota riyadh	HUKUM
suap hakim jabat ma tidak jatuh sanksi	HUKUM
istana belum bahas densus tipikor kapolri akan minta jelas	HUKUM
tak mudah tetap sangka kembali kpk evaluasi kasus novanto	HUKUM
korupsi jadi musuh besar sadar sama butuh	HUKUM
surat dari fadli zon protes kpk tidak tunda periksa	HUKUM
berantas korupsi novel baswedan dua kali lapor ke polisi	HUKUM
dana desa simpang terus jadi	HUKUM
depan etika politik perintah tak akan ikut campur kasus novanto	HUKUM
rkuhp komnas ham nyata berat ke presiden	HUKUM
jamin perintah dan dpr ragu	HUKUM
malaysia mahathir najib cekal demi tega hukum	HUKUM
butuh terobos atas korupsi	HUKUM
narkoba selundup besar sabu gagal	HUKUM
akhir karier politik koruptor	HUKUM
slankers berantas narkoba	HUKUM
babak baru berantas narkoba	HUKUM
korupsi usut dapat seleweng	HUKUM
jahat siber retas di 44 negara ajar otodidak	HUKUM
waspada pasal karet di rkuhp	HUKUM
terobos politik butuh	HUKUM
berantas korupsi optimal regulasi yang sedia	HUKUM
cegah korupsi kian desak	HUKUM
evaluasi adil desak	HUKUM
analisis politik perda agama	HUKUM
korupsi antikorupsi jadi bagi strategi budaya	HUKUM
korupsi mati kreativitas	HUKUM
sadar moral rusak	HUKUM
isu ham jadi tantang	HUKUM
korupsi ktp-el kpk mulai proses terang palsu miryam	HUKUM
lembaga masyarakat yasonna peras tahan pidana	HUKUM
tahan kabur derita napi hidup di bui	HUKUM
hormat proses hukum vonis 2 tahun penjara basuki aju banding	HUKUM
tangguh belum proses seru jaga indonesia muncul di jumlah daerah	HUKUM
vonis basuki keluarga dukung terima putus	HUKUM
opini bpk warna korupsi suap agar dapat status wtp jadi ulang kali	HUKUM
henti main hakim sendiri kapolri perintah jajar lindung warga	HUKUM
kepala polri ikhtiar tuju polri yang ideal	HUKUM
panitia angket hilang fokus sikap tegas presiden untuk lindung kpk nanti	HUKUM
kpk terus terima dukung panitia angket dpr temu bpk	HUKUM
langgar ham berat mereka yang terus rawat ingat	HUKUM
mk gagal ajar hakim konstitusi patrialis akbar tangkap kpk	HUKUM
saat mk jatuh untuk dua kali	HUKUM
hak asasi manusia populisme jadi ancam	HUKUM
suap di mk arief badan adil tidak boleh awas	HUKUM
tega hukum pns cuci uang rp 1 3 triliun masih bebas	HUKUM
berantas korupsi kpk suap untuk kuasa impor daging	HUKUM
bunuh kim jong nam duga libat korut kuat	HUKUM
ktp-el korupsi nyaris sempurna ketua kpk akan ada sangka baru	HUKUM
imigrasi adil as tunda deportasi 51 wni	HUKUM
novanto masuk tahan rawat inap tidak butuh	HUKUM
berantas korupsi kapolri kami tak ingin gaduh	HUKUM
bandar bidik usia tk-sd lindung lap hadap anak desak laku	HUKUM
kasus ktp-el nasib novanto tentu hari ini	HUKUM
2 tewas 57 orang rawat delapan sangka tangkap kandung obat masih teliti	HUKUM
kasus ktp-el mkd dalam kasus fadli zon	HUKUM
berantas korupsi kpk dan ma sih adil	HUKUM
kriminalitas jejak curi teripang di jakarta dua	HUKUM
benah sistem manajemen perkara banyak celah korupsi adil	HUKUM
panitera adil	HUKUM
lp belum benah serius berantas narkoba perlu bijak komprehensif	HUKUM
kriminalitas 149 wna jahat siber bekuk	HUKUM
narkoba rongrong negara	HUKUM
narkoba kapolri dukung tembak bandar	HUKUM
korupsi ktp elektronik novanto sebut jumlah nama baru	HUKUM
narkoba 1 2 juta ekstasi sita satu tewas tembak	HUKUM
dpr sandera kpk masa kerja panitia angket panjang	HUKUM
ma butuh evaluasi total ketua pt sulawesi utara tangkap kpk	HUKUM
presiden tagih polri mahfud kasus novel tak sulit	HUKUM
komitmen elite tanya kasus ktp elektronik tak bahas dalam temu presiden	HUKUM
dpr jadi lembaga korup ada ktp elektronik duga korupsi sejak dari rencana	HUKUM
ruu tembakau regulasi sehat ancam gugur	HUKUM
perkara korupsi cabut hak politik belum cukup	HUKUM
wawancara khusus strategi lanjut atas timpang	HUKUM
narkoba edar dari lp lama jadi	HUKUM
suap gubernur bengkulu keluarga masuk dalam pusar korupsi	HUKUM
angket kpk dpr aku sanksi anggar jadi opsi	HUKUM
presiden siap sikap tolak hadap angket luas ke daerah	HUKUM
berantas korupsi lima tangkap dalam bulan	HUKUM
presiden dukung penuh kpk tolak angket apresiasi	HUKUM
kpk tak gentar hadap teror ada lawan dari pihak yang usut kpk	HUKUM
sidang siti aisyah perintah ri tunjuk lima acara malaysia	HUKUM
bencana di gunung wilis curi kulit kayu makin marak	HUKUM
adil koneksitas usul pati tni au sangka korupsi	HUKUM
kpk habis sikap tegas presiden tunggu	HUKUM
momentum benah bumn kpk tetap mantan dirut garuda indonesia emirsyah satar jadi sangka	HUKUM
sanksi bagi koruptor masih rendah baik tega hukum	HUKUM
bisnis narkoba kendali di 39 lp menteri hukum dan ham wacana rotasi napi	HUKUM
tega hukum niwen akhir eksekusi	HUKUM
kpk tak gentar hadap bantah kasus ktp elektronik malu	HUKUM
kriminalitas berandal motor jarah toko pakai	HUKUM
berantas korupsi ungkap laku butuh terobos	HUKUM
mafia adil sikap tegas ma butuh	HUKUM
thailand yingluck susul thaksin ke dubai	HUKUM
novel baswedan tak ada alas kasus tidak tuntas	HUKUM
kasus korupsi putus mundur idrus sikap dengan cepat	HUKUM
berantas korupsi baik sistem anggar desak	HUKUM
bahan bahaya jual bebas	HUKUM
putus mk buka ruang intervensi	HUKUM
jerat hukum atas najib kian kuat	HUKUM
korupsi di legislatif partai politik tanggung jawab	HUKUM
program antikorupsi jadi jual	HUKUM
atur ras dan etnis lupa	HUKUM
kepala daerah tidak juga jera	HUKUM
duga korupsi taufik duga terima imbal dari elite politik	HUKUM
korupsi ancam demokrasi	HUKUM
tantang demokrasi saat korupsi elite lelah pilih	HUKUM
liput investigasi liku pasar gelap dokumen negara	HUKUM
cepat baik sdm di lapas	HUKUM
ruu jabat hakim awas ky demi akuntabilitas adil	HUKUM
uji materi uu sisdiknas capres undang bagai pihak kait	HUKUM
asi games mereka yang tugas di balik pesta besar	HUKUM
kpk hadir novanto mangkir suasana rapat komisi iii dpr mirip panitia angket	HUKUM
edar pcc jahat manusia edar laku regenerasi guna narkoba	HUKUM
ketua dpr surat novanto picu polemik	HUKUM
hakim kusno saya belum pernah kabul	HUKUM
cepat tangan novanto partai golkar tunggu praperadilan	HUKUM
atur skor momentum sih sepak bola nasional	HUKUM
atur skor panggil oleh pssi tidak hirau	HUKUM
lembaga adil ma telusur duga iur tidak resmi	HUKUM
2 357 asn pidana akan pecat	HUKUM
kriminalitas lapas jadi pasar narkoba	HUKUM
korea selatan tambah hukum mantan presiden park	HUKUM
korupsi ktp-el tindak ikut baik sistem	HUKUM
31 orang tewas sia	HUKUM
minum keras oplos jangan sekadar reaksi saat	HUKUM
air indonesia jadi jalur edar narkoba	HUKUM
tembak massal aksi cruz harus dapat cegah	HUKUM
korupsi kepala daerah parpol nilai gagal cetak kader	HUKUM
waspada curi data atm masif	HUKUM
ruu hukum pidana dpr tidak mau buru	HUKUM
indonesia tempat uji coba narkoba	HUKUM
awas ma tak efektif sejak 2012 ada 14 hakim kena kasus korupsi	HUKUM
kpk akan minta bantu idi novanto tetap proses hukum	HUKUM
novanto bisa sangka lagi kpk yakin milik bukti yang kuat	HUKUM
narkoba jumlah sangka status ajar tingkat	HUKUM
kpk-novanto adu siasat pimpin dpr minta sidi henti sementara	HUKUM
terjun tim untuk berantas preman basuki masalah drainase	HUKUM
duga suap wakil ketua komisi vii dpr tangkap kpk	HUKUM
masyarakat masih permisif pada korupsi	HUKUM
izin turut picu suap	HUKUM
korupsi bajak sejahtera masyarakat	HUKUM
dinamika masyarakat saat wong cilik lihat korupsi	HUKUM
rusa polsek ciracas polri dan tni kerja sama ungkap laku	HUKUM
teknologi finansial selesai kasus kendala akses data	HUKUM
awas eksternal kuat	HUKUM
jalan tol belum nyaman debu jadi masalah utama - mudik gesit	INDUSTRI
keluar jakarta macet parah ada tiga jalur selain jalan tol - liput lebaran 2017	INDUSTRI
macet parah antisipasi jakarta-cikampek jadi fokus - liput lebaran 2017	INDUSTRI
tunda operasi truk dua kapal gratis siap - liput lebaran 2017	INDUSTRI
curi ikan nelayan asing bebas operasi di malu	INDUSTRI
manufaktur sentuh titik nadir daya saing industri belum banyak ubah	INDUSTRI
panen raya kejar matahari buru harga	INDUSTRI
mandiri warga setia hidup waris gerabah klipoh kompas bike jateng gayeng	INDUSTRI
daya tarik destinasi peran penting persepsi pengaruh pariwisata	INDUSTRI
industri rajin saat ukir jepara genggam asing	INDUSTRI
industri mebel puruk banyak 2 1 juta orang ancam anggur	INDUSTRI
infrastruktur desa juang tembus jalan rusak	INDUSTRI
langka garam perintah cari solusi industri kian tekan	INDUSTRI
tani hak sejahtera	INDUSTRI
hidup tekor pahlawan pangan	INDUSTRI
wisata jakarta kecewa di beranda indonesia	INDUSTRI
tani subsidi pupuk dan benih tak efektif	INDUSTRI
ideafest 2017 ribut politik maaf kreator muda sibuk karya	INDUSTRI
manfaat laut adu cepat arif lokal dan rusa air jelajah terumbu karang	INDUSTRI
generasi milenial sulit beli rumah	INDUSTRI
padat masih bayang mudik mudik gesit 2018	INDUSTRI
macet masih bayang mudik	INDUSTRI
ranah mang beras dera nan tanamo sumbar sabana rancak	INDUSTRI
nelayan cantrang laut dalam bayang kalut	INDUSTRI
ikan biasa nelayan perlu ubah	INDUSTRI
demi ekosistem bawah laut	INDUSTRI
pangan lokal gigih tani hanjeli lawan ironi	INDUSTRI
kebun kerja keras yang buah hasil	INDUSTRI
ubah iklim tanam kopi yang selamat hutan jelajah kopi nusantara	INDUSTRI
transportasi kuat layar rakyat untuk dukung tol laut	INDUSTRI
cacing di ikan kaleng produsen ikan olah di muncar pukul	INDUSTRI
intervensi pusat nanti	INDUSTRI
angkut daring serikat kuat jangan bablas	INDUSTRI
komunitas daya dulu ganja kini padi dan palawija	INDUSTRI
nelayan siap ganti alat	INDUSTRI
ikan kota udang tak punya udang	INDUSTRI
bandara kertajati pacu tumbuh wilayah	INDUSTRI
tol makin padat truk mudik gesit 2018	INDUSTRI
tiket bus tiada disrupsi digital di terminal	INDUSTRI
infrastruktur bandara a yani pacu daya saing jateng	INDUSTRI
komoditas pangan tani samosir bisa sekali tanam	INDUSTRI
ekspedisi wallacea hutan aketajawe rumah sunyi suku tobelo dalam	INDUSTRI
arus kendara terus tingkat	INDUSTRI
terbang murah ekonomi daerah ikut tingkat	INDUSTRI
pulih optimisme terbang	INDUSTRI
huni lupa biasa lama	INDUSTRI
jalur puncak tutup 12 jam jembatan cipamingkis dapat lewat - tahun baru 2018	INDUSTRI
pantura landa macet lalu lintas terbang di bandara soekarno-hatta padat 2 660 terbang lambat - natal 2017	INDUSTRI
waspada macet di akhir tahun tol cikampek dan brebes timur jadi perhati natal 2017	INDUSTRI
tol bisa pacu industri tani distribusi energi listrik belum rata	INDUSTRI
rempah pedas lada putih belitung	INDUSTRI
arus balik imbau polisi belum taat liput lebaran 2017	INDUSTRI
komoditas kopi yang adil dari malang raya	INDUSTRI
keliru data pangan dapat picu gejolak alokasi subsidi bisa meleset	INDUSTRI
jaring cantrang tanpa alternatif akan miskin nelayan	INDUSTRI
transportasi daring payung hukum siap masyarakat minta tidak resah	INDUSTRI
bandara silangit ledak pariwisata dari danau toba	INDUSTRI
infrastruktur sumatera daya saing komoditas ekspor tak kompetitif	INDUSTRI
lumbung pangan tani alami dan daulat di salassae	INDUSTRI
ekspedisi jalur rempah kisah aroma nusantara mikat dunia jalur rempah nusantara	INDUSTRI
forum pangan asia pasifik diversifikasi pangan jadi andal	INDUSTRI
ikan satgas fasilitas modal nelayan	INDUSTRI
pariwisata ubah pantai kumuh jadi seri	INDUSTRI
proyek infrastruktur mulai rasa waspada efek bumerang bagi daerah sekitar - 3 tahun perintah jokowi-jk	INDUSTRI
laku pariwisata bal tak ingin sunset hadir di pantai amed	INDUSTRI
benih unggul tani daya di lahan payau	INDUSTRI
industri mebel usaha minta mudah bahan baku	INDUSTRI
indikator ekonomi konsumsi perlu lebih cermat	INDUSTRI
puncak dan eksploitasi yang tak ujung	INDUSTRI
infrastruktur dinding itu mupus hidup putri	INDUSTRI
tol laut subsidi harus bareng instrumen dukung	INDUSTRI
analisis ekonomi ancam krisis dagang	INDUSTRI
ganjil-genap di tol cikampek padat lalu lintas turun	INDUSTRI
maritim nelayan pati mulai laut ke arafura	INDUSTRI
upaya daya cangkir senyum untuk semua	INDUSTRI
butuh pokok perintah evaluasi tender tol laut	INDUSTRI
tunda terap atur kontradiktif	INDUSTRI
moda sungai nyaris punah	INDUSTRI
pariwisata gwk telah 28 tahun nanti	INDUSTRI
tradisi daun kopi yang redam konflik	INDUSTRI
lonjak mudik antisipasi mudik gesit 2018	INDUSTRI
mudik lebaran 2018 tantang hadang elektronifikasi tol mudik gesit 2018	INDUSTRI
jelajah kopi nusantara sukacita gelombang tiga	INDUSTRI
libur lebaran kaum muda gerak pariwisata	INDUSTRI
tol trans-jawa surabaya-jakarta bisa tempuh 10-12 jam	INDUSTRI
satu data indonesia bijak tepat dan cepat butuh sistem data integrasi	INDUSTRI
terbang murah jadi daya tarik	INDUSTRI
macet hingga april 2019	INDUSTRI
industri mebel svlk justru bantu ikm ekspor langsung	INDUSTRI
transportasi daring tanpa atur lagi masyarakat tidak lindung	INDUSTRI
awal dari gelisah	INDUSTRI
tani organik lahan kritis itu kembali hijau	INDUSTRI
nasib tani perintah hanya diam saat harga panen jatuh	INDUSTRI
rumah harga lahan mahal rusun jadi solusi	INDUSTRI
huni siasat papan generasi milenial	INDUSTRI
ganti cantrang terus dorong	INDUSTRI
jangan main dengan masa depan orang	INDUSTRI
wilayah luar senyum lebar nelayan natuna	INDUSTRI
industri digital tuntut kompetensi lulus dalam negeri serap	INDUSTRI
waspada gejolak beras stok nilai kurang ideal	INDUSTRI
beras bencana di dapur keluarga sijan	INDUSTRI
industri mebel bawa ke ratas biaya buat dokumen svlk berat rajin	INDUSTRI
mebel rotan rajin rotan cirebon tahan jadi ternak	INDUSTRI
biaya ekonomi tinggi di lintas sumatera biar preman resah usaha	INDUSTRI
distribusi barang jalur neraka yang harus lalu	INDUSTRI
ikan 14 jam tarung di laut seram	INDUSTRI
7 skenario atas beban puncak arus balik mulai tingkat	INDUSTRI
kuat atur jalan tol jalan reguler bisa jadi pilih - mudik gesit	INDUSTRI
fenomena bus mewah tak lagi sekadar ac dan wc	INDUSTRI
antisipasi lonjak mudik mudik gratis swasta mulai - mudik gesit	INDUSTRI
derita tani tebu kian parah syarat kur berat	INDUSTRI
infrastruktur presiden - proyek bijb cepat	INDUSTRI
industri olah tiap usaha serap 2-4 tenaga kerja	INDUSTRI
nelayan kecil kami tidak cari kaya	INDUSTRI
mudik motor butuh solusi jalan tol palembang ambles - liput lebaran 2017	INDUSTRI
kisah mudik sepeda motor taruh nyawa demi temu keluarga	INDUSTRI
wisata obama awal kunjung pribadi di indonesia	INDUSTRI
polisi ketat aman rekayasa lalu lintas efektif - liput lebaran 2017	INDUSTRI
kisah para mudik mak anak pulang	INDUSTRI
infrastruktur tarif 13 ruas jalan tol usul naik	INDUSTRI
tani asa mandiri dari lahan tidur	INDUSTRI
tani muda jadi tani siapa takut	INDUSTRI
festival poso raya baik alam	INDUSTRI
rumah butuh generasi milenial geser	INDUSTRI
tahan pangan sekolah lapang jadi tani sekaligus ternak	INDUSTRI
ladang jaga lahan semi tanpa api	INDUSTRI
cantrang sus potensi sumber daya ikan tingkat	INDUSTRI
sewa unit di rusunawa lebih baik enggak beli apa dulu daripada nunggak	INDUSTRI
transportasi haji terbang pindah dari halim	INDUSTRI
infrastruktur 6 000 titik jembatan ampera retak	INDUSTRI
gairah ekonomi sambut lebaran	INDUSTRI
mudik prioritas mudik gesit 2018	INDUSTRI
mudik lebaran 2018 ketidaktertiban kendara sorot mudik gesit 2018	INDUSTRI
tugas mudik obat sabar tak boleh habis	INDUSTRI
siaga hadap arus balik mudik gesit 2018	INDUSTRI
budidaya kopi ikhtiar berdikari tani mandiri jelajah kopi nusantara	INDUSTRI
layar rakyat merana	INDUSTRI
layar rakyat wilhelmus ganti tumpang di laut	INDUSTRI
atur ojek daring ruwet	INDUSTRI
provinsi lampung pariwisata bisa jadi sumber ekonomi baru	INDUSTRI
pariwisata mikat unjung di rumah gajah	INDUSTRI
tol laut belum efektif	INDUSTRI
infrastruktur proyek rel dwiganda evaluasi	INDUSTRI
pangan lokal mereka yang rawat dan yang kembali	INDUSTRI
ri punya posisi tawar yang kuat	INDUSTRI
tahan pangan diversifikasi pangan jadi kunci	INDUSTRI
ikan sulit kapal di lumbung ikan	INDUSTRI
ikan nelayan minta waktu alih	INDUSTRI
budidaya udang cerita kelu tambak bratasena	INDUSTRI
angkut daring tegas mari kaca ke negeri seberang	INDUSTRI
jelajah kopi nusantara lepas profesi demi kedai keliling	INDUSTRI
peluang buka lebar	INDUSTRI
layar rakyat jerat utang terjang gelombang	INDUSTRI
komoditas ekspor harap baru tani pisang tanggamus	INDUSTRI
festival kopi nusantara hidup ajang dialog hulu-hilir	INDUSTRI
arus balik waspada titik macet mudik gesit 2018	INDUSTRI
jalan tol trans-jawa presiden harap titik tumbuh integrasi	INDUSTRI
perilaku mudik warga ubah mudik gesit 2018	INDUSTRI
titik macet geser mudik gesit 2018	INDUSTRI
natal-tahun baru tol trans-jawa siap waspada macet liput natal 2018	INDUSTRI
infrastruktur baik jalur alternatif ke kawasan puncak	INDUSTRI
pariwisata buru swafoto hingga kebun singkong borobudur marathon 2018	INDUSTRI
kultur kopi kopi papua hona	INDUSTRI
transportasi proyek di tol cikampek henti sementara natal 2017	INDUSTRI
beras mati dini giling kecil	INDUSTRI
jalan tol bawen-salatiga siap saat lebaran	INDUSTRI
infrastruktur gelut dengan lumpur di jalan sepucuk-cengal	INDUSTRI
transportasi cuaca buruk bisa ganggu mudik	INDUSTRI
moda transportasi bus jaya yang kini tinggal kenang	INDUSTRI
data pangan hitung baru padi uji di seluruh jawa	INDUSTRI
angkut lebaran bus tidak laik jadi ancam mudik gesit	INDUSTRI
siap mudik korlantas siap lima skenario atas macet mudik gesit	INDUSTRI
nasib tani hidup hambar di lumbung garam	INDUSTRI
infrastruktur jakarta konstruksi mrt sudah 74 persen	INDUSTRI
pariwisata jual awan di lolai	INDUSTRI
mata cari tali nelayan natuna dan pancing	INDUSTRI
industri manufaktur tingkat daya saing mutlak perlu	INDUSTRI
pariwisata ancam stagnan konektivitas belum jamin daerah kembang	INDUSTRI
industri mebel sosialisasi svlk desak benah	INDUSTRI
tani derita buruh dan tani di lumbung padi	INDUSTRI
regenerasi tani ketika padi tak lagi melambang makmur	INDUSTRI
tani regenerasi mandek pangan jadi rentan	INDUSTRI
tani karet beli beras pun tak sanggup	INDUSTRI
industri digital atur khusus perlu bagi transportasi daring	INDUSTRI
teknologi dirgantara jalan liku pesawat n219	INDUSTRI
tani tani tak lagi bakar lahan	INDUSTRI
nelayan landa resah upaya lestari laut tidak ikut bijak yang komprehensif	INDUSTRI
ekspedisi jalur rempah harum samar tani cengkeh jalur rempah nusantara	INDUSTRI
aman taksi daring lemah	INDUSTRI
usaha harus tanggung jawab	INDUSTRI
pariwisata kopi demi sensasi di keping surga jelajah kopi nusantara	INDUSTRI
dpr bakal bangun gedung baru anggar jadi rp 5 7 triliun	INDUSTRI
jelajah sepeda flores dari atas sadel nikmat panorama	INDUSTRI
kisruh gula tani tak punya modal tanam tebu	INDUSTRI
infrastruktur pariwisata jalan derita tuju wae rebo	INDUSTRI
dampak lingkung ironi kerang hijau di teluk jakarta	INDUSTRI
komoditas kisah sunyi tani kopi wonosalam	INDUSTRI
infrastruktur telah 21 tahun tol becakayu wujud	INDUSTRI
perintah ikan adil revisi permenhub nomor 32 tahun 2016	INDUSTRI
infrastruktur proyek perlu siap matang	INDUSTRI
terna rakyat ayam makan ayam jadi pilih akhir ternak	INDUSTRI
infrastruktur jalan cerita nestapa di jalur lama pantura jabar	INDUSTRI
bangun uji berat saat ingin bangkit	INDUSTRI
hubung jumlah masalah transportasi daerah mulai urai	INDUSTRI
industri dirgantara produksi n219 bisa gerak ekonomi	INDUSTRI
jalan tol macet arteri lancar jalur pantura tengah dan selatan bisa jadi pilih	INDUSTRI
jebak di jalur masuk semarang	INDUSTRI
tani rimbun sayur yang ubah citra kampung	INDUSTRI
insiden laut diplomatik jadi jalan selesai	INDUSTRI
komoditas telur para ternak ayam hantu cemas	INDUSTRI
angkut lebaran mudik sepeda motor paling risiko mudik gesit	INDUSTRI
arus balik rekayasa polisi kurang beban macet liput lebaran 2017	INDUSTRI
tertib lalu lintas cegah maut datang terlalu cepat	INDUSTRI
distribusi barang biaya angkut naik karena jalan rusak	INDUSTRI
jahat ikan negara tak boleh kalah	INDUSTRI
tani dapat pasti hukum akses untuk dapat kur	INDUSTRI
mudik sepeda motor cuaca dan truk jadi kendala mudik gesit 2018	INDUSTRI
mudik lebaran 13 juta mudik telah pulang kampung mudik gesit 2018	INDUSTRI
arus balik belum semua mudik kembali	INDUSTRI
ganjil-genap momentum tata transportasi massal	INDUSTRI
ganjil genap nilai hasil tetapi baru jangka pendek	INDUSTRI
festival kopi nusantara daerah gerak hidup kopi	INDUSTRI
akses di 13 jalan batas	INDUSTRI
lrt jakarta kejar waktu operasi saat asi games	INDUSTRI
bikin sendiri daripada beli	INDUSTRI
inovasi desa sulap rawa jadi magnet wisata	INDUSTRI
pinisi ironi di tanah asal laut ulung	INDUSTRI
maskapai murah mati	INDUSTRI
geliat ekonomi kian rata liput natal 2018	INDUSTRI
libur tahun baru wisatawan masih minat obyek wisata pantai liput tahun baru 2019	INDUSTRI
jelang asi games empat paket bijak siap	INDUSTRI
transformasi sosial jangan jatuh di kampung saga	INDUSTRI
kompas travel fair2018 cinta indonesia lewat wisata	INDUSTRI
angkut umum nama bemo di atap qute	INDUSTRI
tuah kopi sabung	INDUSTRI
jelang tahun baru waspada jalur alternatif tahun baru 2018	INDUSTRI
mudik saran pakai jalur arteri puncak arus prediksi sabtu ini - natal 2017	INDUSTRI
diskresi polisi jadi kunci	INDUSTRI
uji kir jumlah unit layan minim subur calo	INDUSTRI
angkut logistik ketidakpastian di akses labuh	INDUSTRI
kopi liberika mutiara gambut semai sejahtera festival kopi nusantara	INDUSTRI
industri mebel redup pusat ukir dunia di jepara	INDUSTRI
liput investigasi tanpa pihak indonesia bakal kembali jadi pasar	INDUSTRI
analisis ekonomi revolusi industri 4 0	INDUSTRI
janji menhub hidup pelra	INDUSTRI
jelajah kopi nusantara saat urus waris abadi	INDUSTRI
kelapa sawit delegasi uni eropa ecek kebun	INDUSTRI
angkut daring usaha wajib tanggung jawab	INDUSTRI
pariwisata dengung toleransi dan harmoni dari jaipur	INDUSTRI
ragam pangan abai	INDUSTRI
hari pejal kaki peluit darurat masih lengking	INDUSTRI
pariwisata jebak pesona agung pulau dewata	INDUSTRI
hari kopi internasional dari cangkir kopi semua mula	INDUSTRI
lalu lintas jalan bukan sirkuit balap ayo tertib	INDUSTRI
uji kir sarat pungli dan calo	INDUSTRI
karyawan jadi kunci	INDUSTRI
mrt jakarta pinjam pakat fase ii lelang	INDUSTRI
pariwisata antar semarang jadi gerbang wisata semarang 10k	INDUSTRI
ekowisata magnet ekonomi baru di atap sulawesi	INDUSTRI
rekayasa atas macet liput natal 2018	INDUSTRI
tol trans jawa telah dua abad lalu	INDUSTRI
virus goldeneye-petya ancam lebih besar perlu antisipasi	IPTEK
satelit telekomunikasi luncur sukses telkom 3s gerak tuju orbit	IPTEK
satwa langka lagi ekor gajah mati racun	IPTEK
stephen hawking ilmuwan unggul yang juga manusia biasa	IPTEK
telekomunikasi satelit merah putih orbit	IPTEK
gerhana bulan total buru pesona dewi candra	IPTEK
darat di mars teror tujuh menit dan rumah dua kita	IPTEK
digital nomad ya kerja ya libur lapor akhir tahun	IPTEK
adu generasi mata versus monster	IPTEK
cerdas digital dunia dalam big data	IPTEK
serang siber ratus ribu sistem di 100 negara lumpuh	IPTEK
cerdas buat hubung emosional tak ganti	IPTEK
masyarakat antusias lihat gerhana	IPTEK
analisis ekonomi tumbuh model baru	IPTEK
publikasi riset bebas akademik ancam	IPTEK
batas gawai pada anak	IPTEK
permisif hadap gawai	IPTEK
waspada dampak air laut pasang	IPTEK
soal pasang laut	IPTEK
virus goldeneye-petya serang saat libur antisipasi jadi rumit	IPTEK
aman internet serang siber sementara kendali	IPTEK
serang siber obyek vital dan korporasi tingkat aman jaring	IPTEK
media sosial kuat tahan generasi muda	IPTEK
wilayah luar sampan 3 5 jam demi sinyal	IPTEK
kaum muda optimistis pada 2018 tetap karya untuk baik	IPTEK
telkom 1 dan arah antena yang ubah	IPTEK
fenomena alam masyarakat antusias saksi gerhana bulan total	IPTEK
cerdas buat tidak elak putus gantung big data	IPTEK
data beri daya	IPTEK
cerdas buat manusia kembang komplementer	IPTEK
inovasi mahasiswa antar batang gebang kian pandang	IPTEK
telekomunikasi telkom cepat pulih layan	IPTEK
fenomena sudah anda ngevlog	IPTEK
bebas informasi hoax ancam satu bangsa	IPTEK
serang siber makin kencang motivasi serang alih dari ekonomi ke politik	IPTEK
serang siber saat tim aman bentuk	IPTEK
bahaya yang jual bebas	IPTEK
satelit babak baru untuk mandiri antariksa	IPTEK
literasi digital ajar anak buat konten positif	IPTEK
rancang undang riset buka peluang masa depan	IPTEK
lindung anak cegah siswa hanyut dalam tsunami digital	IPTEK
ekonomi digital usaha rintis digital terus bangun	IPTEK
okok kalau sakit kan ada kartu	KESEHATAN
bangsa para jaga imaji indonesia	KESEHATAN
pcc sudah lama larang edar tanya	KESEHATAN
pcc yang buat heboh	KESEHATAN
imunisasi jalan 10 jam demi anak di dalam	KESEHATAN
kasus difteri terus tambah cakup imunisasi luas	KESEHATAN
sakit katastropik beban ekonomi negara tambah	KESEHATAN
krisis sehat di asmat 4 tim medis kirim ke 5 distrik	KESEHATAN
misi manusia gulir	KESEHATAN
layan sehat kuat puskesmas desak laku	KESEHATAN
puskesmas kami bawa hati walau kira sales panci	KESEHATAN
krisis sehat di asmat lagi orang anak balita tinggal	KESEHATAN
rp 3 triliun dana kapitasi endap	KESEHATAN
daerah batas rumput sendiri kini jauh lebih hijau	KESEHATAN
jamin sehat beban serta jkn masih tinggi	KESEHATAN
akses sehat layan lewat botol bekas	KESEHATAN
sanitasi bangun sadar warga sejak dini	KESEHATAN
hiv aids tolak odha karena edukasi minim	KESEHATAN
kualitas layan jkn belum prima	KESEHATAN
vaksinasi antirabies sadar masyarakat kian tumbuh	KESEHATAN
layan sehat sengat matahari usai amputasi	KESEHATAN
jamin sehat tidak ada lagi batas manfaat bagi serta jkn-kis	KESEHATAN
krisis sehat asmat sedia air bersih dan sanitasi prioritas	KESEHATAN
layan sehat warga asmat butuh damping	KESEHATAN
krisis sehat lagi 31 derita gizi buruk temu	KESEHATAN
obat di rs agats tip	KESEHATAN
61 anak tinggal di asmat	KESEHATAN
bencana sehat di asmat tangis akhir untuk theresia bewer	KESEHATAN
layan sehat angka sakit dan mati tinggi	KESEHATAN
puskesmas ujung tombak yang lupa	KESEHATAN
jadi luar biasa difteri sistem informasi sehat lemah	KESEHATAN
imunisasi mutu vaksin harus jamin	KESEHATAN
difteri vaksinasi masih ragu warga	KESEHATAN
inovasi layan sehat berkat gandrung pasien tak lagi murung	KESEHATAN
jamin sehat akses serta jkn luas	KESEHATAN
siap mudik fasilitas sehat wajib buka 24 jam mudik gesit	KESEHATAN
sakit langka mereka ada dan tetap penuh harap	KESEHATAN
hari kanker dunia rawat cita di rumah sama	KESEHATAN
tarif jkn jadi masalah layan rs belum optimal	KESEHATAN
lagi dua anak balita tinggal di asmat	KESEHATAN
rs agats kewalahan	KESEHATAN
krisis sehat asmat mereka derita sejak di kandung	KESEHATAN
jamin sehat komitmen perintah tanya	KESEHATAN
cacing di ikan kaleng karantina tingkat waspada	KESEHATAN
sehat 66 juta warga belum lindung	KESEHATAN
jamin sehat lindung finansial yang belum optimal	KESEHATAN
solusi defisit jkn tambal sulam	KESEHATAN
79 000 klaim rs potensi anomali	KESEHATAN
rehabilitasi mental gending pulih jiwa di sanatorium borobudur marathon 2018	KESEHATAN
hari aids dunia stigma hadap odha masih jadi	KESEHATAN
inovasi puskesmas masyarakat tak lagi rasa tinggal	KESEHATAN
krisis sehat kasus gizi buruk dan campak luas	KESEHATAN
jamin sehat antre lama demi layan	KESEHATAN
mutu layan jkn tak rata antre pasien masih jadi	KESEHATAN
sakit tular difteri jadi di 19 provinsi	KESEHATAN
sehat ibu dan anak wujud revolusi dari timur	KESEHATAN
layan sehat haru yospina temu dokter	KESEHATAN
fasilitas publik tatkala alam panggil di tengah macet	KESEHATAN
ancam dari udara air dan makan	KESEHATAN
krisis sehat soal bahan bakar hambat kerja rawan	KESEHATAN
otonomi khusus perlu evaluasi	KESEHATAN
dana kapitasi endap juta warga indonesia rugi	KESEHATAN
bahan baku ikan di kaleng telusur	KESEHATAN
sumber daya manusia kualitas dan produktivitas manusia indonesia ancam	KESEHATAN
jamin sehat kendali biaya perlu tegas	KESEHATAN
candu gawai ancam anak	KESEHATAN
adiksi candu gawai nan bius	KESEHATAN
lanjut usia nyala semangat usia senja	KESEHATAN
sanitasi toilet selamat hidup bangsa	KESEHATAN
bencana sehat di asmat sisir ke kampung lanjut	KESEHATAN
kondisi puskesmas sarat beban kapasitas tidak seragam	KESEHATAN
krisis sehat di asmat bulan 13 anak balita tinggal	KESEHATAN
imunisasi kampanye program libat komunitas	KESEHATAN
produk farmasi berantas penyalahgunaan obat intensif	KESEHATAN
zat psikoaktif dulu dan kini	KESEHATAN
bpjs sehat langkah atas defisit efektif per semester ii	KESEHATAN
150 tahun rsj soeharto heerdjan ubah stigma derita ganggu jiwa	KESEHATAN
gaya hidup sehat ideologi baru untuk badan baru	KESEHATAN
bayi debora dki panggil kelola rs mitra keluarga	KESEHATAN
upaya sehat tangkai melati selamat ibu hamil risiko tinggi	KESEHATAN
dana kapitasi perlu ubah regulasi agar transparan	KESEHATAN
cacing di ikan kaleng dampak sosial dan ekonomi pukul dunia usaha	KESEHATAN
jamin sehat cegah sakit korban	KESEHATAN
wujud jamban komunal	KESEHATAN
buang air besar dan sdgs	KESEHATAN
sanitasi untung ada kredit jamban	KESEHATAN
okok beban jkn beli produk tembakau per hari lebih dari rp 605 miliar	KESEHATAN
sehat mereka dalam cengkeram candu rokok	KESEHATAN
sakit tular 750 orang gigit anjing rabies	KESEHATAN
bayi debora dua lalai pihak rumah sakit	KESEHATAN
sehat anak ancam cakup imunisasi tak rata kebal komunitas belum sempurna	KESEHATAN
imunisasi dari alas yakin hingga tahu	KESEHATAN
sehat warga luka salma potret buram kita	KESEHATAN
jamin sehat ganggu arus kas 164 rumah sakit	KESEHATAN
layan sehat janin tinggal minggu dalam kandung hersin	KESEHATAN
krisis sehat di asmat peran guru hilang di kampung	KESEHATAN
jamin sosial sumber dana lain perlu maksimal	KESEHATAN
puasa tubuh pun butuh istirahat	KESEHATAN
imunisasi mr mui masyarakat tak perlu ragu	KESEHATAN
jamin sehat kualitas layan untuk serta jkn belum optimal	KESEHATAN
tempe dari serat centhini ke luar angkasa	KESEHATAN
bencana sehat di asmat rsud agats butuh tambah awat	KESEHATAN
bencana sehat di asmat	KESEHATAN
difteri delapan provinsi imunisasi ulang 2018	KESEHATAN
liput investigasi anak jadi korban	KESEHATAN
evaluasi dalam program jkn-kis	KESEHATAN
risiko turun ri makin tarik politik pengaruh jangka pendek	KEUANGAN
bijak fiskal efisiensi laku pada pos yang tak produktif	KEUANGAN
ampun pajak serta harus segera penuh komitmen	KEUANGAN
gera tabung si miskin pun daya di gang swadaya	KEUANGAN
komitmen hadap dana desa tak ubah awas uang kuat	KEUANGAN
mudah usaha sistem paja belum ramah untuk usaha	KEUANGAN
perintah mesti ikut topang	KEUANGAN
analisis ekonomi jaga rupiah	KEUANGAN
paja otentisitas omzet bisa uji	KEUANGAN
manfaat peluang dalam dinamika ekonomi global kompas100 ceo forum	KEUANGAN
langkah lanjut jaga rupiah	KEUANGAN
diaspora bukti etos kerja di tanah suci	KEUANGAN
suku bunga bi jaga daya tarik pasar	KEUANGAN
kompas 100 ceo forum 2018 ganti impor belum optimal tuju kompas 100 ceo forum	KEUANGAN
anggar janji program adil belanja negara rp 2 204 triliun	KEUANGAN
bijak moneter dampak ketat akan beda	KEUANGAN
ampun pajak kemenkeu siap daftar target	KEUANGAN
daya semai jiwa wirausaha	KEUANGAN
kongres ekonomi umat masyarakat dorong untuk berwirausaha	KEUANGAN
daya desa sukses tidak hanya ada di kota besar	KEUANGAN
pasca ampun pajak mereka yang partisipasi tidak jadi prioritas	KEUANGAN
e-budgeting mesti lanjut gubernur datang perlu sempurna sistem	KEUANGAN
fiskal dana alokasi umum potong 3-4 persen	KEUANGAN
ampun pajak harta kas simpan di dalam negeri	KEUANGAN
bijak ampun modal besar untuk reformasi pajak	KEUANGAN
pajak jendela untuk deklarasi harta buka lagi	KEUANGAN
nilai tukar rupiah lemah dampak cegah	KEUANGAN
nilai tukar sentimen positif belum bentuk	KEUANGAN
analisis ekonomi normalisasi rupiah	KEUANGAN
perang dagang pasar saham global respons positif sepakat china-as	KEUANGAN
awas dana desa minim kpk sampai rekomendasi	KEUANGAN
uang elektronik guna harus dapat insentif	KEUANGAN
bijak moneter suku bunga fed naik pasar saham kuat	KEUANGAN
naik biaya kendara kurang sosialisasi buat mereka panik	KEUANGAN
mandiri tomira ideologi rakyat wujud di kulon progo	KEUANGAN
paja terima negara risiko meleset	KEUANGAN
amnesti pajak tinggal enam hari nilai repatriasi masih kecil	KEUANGAN
analisis ekonomi gugat bitcoin	KEUANGAN
baik terus laku masih ada atm dan kantor bank yang belum operasi	KEUANGAN
analisis ekonomi batas bunga acu	KEUANGAN
analisis ekonomi dahulu kurva	KEUANGAN
stabilisasi nilai tukar rupiah jadi prioritas	KEUANGAN
peringkat utang investasi kira bisa tingkat lagi	KEUANGAN
analisis ekonomi konsolidasi fiskal	KEUANGAN
analisis ekonomi utang luar negeri	KEUANGAN
nilai tukar suku bunga acu jadi solusi	KEUANGAN
dana otonomi khusus awas dari pusat masih lemah	KEUANGAN
apbn 2019 fokus manusia lewat investasi didik	KEUANGAN
desa simpan potensi besar	KEUANGAN
upaya tangan hindar pajak	KEUANGAN
paja akses informasi tidak boleh disalahgunakan	KEUANGAN
koperasi makin lupa gotong royong nyaris hilang	KEUANGAN
industri tekfin makin marak baru 157 usaha yang telah daftar di ojk	KEUANGAN
teknologi finansial laku mitigasi antisipasi tipu	KEUANGAN
ampun pajak ribu kemplang tidak partisipasi	KEUANGAN
singapura magnet aset wni ada harta di luar negeri yang duga belum lapor	KEUANGAN
dorong investasi kuat dunia aku langkah baik iklim usaha di indonesia	KEUANGAN
generasi milenial ubah signifikan di dunia bisnis mudaindonesia	KEUANGAN
uang elektronik biaya isi ulang jangan beban guna	KEUANGAN
bijak anggar naik peran daerah makin sentral	KEUANGAN
dana desa lembaga awas pakat kuat	KEUANGAN
pajak sumbang timpang setor pph usaha jauh lebih kecil ketimbang pph karyawan	KEUANGAN
dana desa tanggung jawab program tidak jelas	KEUANGAN
indikator ekonomi inflasi juli 2017 bisa indikasi lesu	KEUANGAN
naik suku bunga bi untuk antisipasi	KEUANGAN
timbang pilih	KEUANGAN
adil dapat himpun pajak jadi soal	KEUANGAN
pajak akhir november eksekusi mulai jalan	KEUANGAN
paja atur dukung siap	KEUANGAN
inovasi teknologi perban pilih rangkul tekfin	KEUANGAN
terima negara kemenkeu mitigasi potensi pajak	KEUANGAN
koperasi jumlah masalah hambat maju	KEUANGAN
apbn 2017 pajak di bawah target utang tambah	KEUANGAN
buah tangan buru oleh rasa artis	KEUANGAN
sektor uang dampak terap akses informasi terus dimitigasi	KEUANGAN
apbn 2018 anggar fokus pada sumber daya manusia	KEUANGAN
gaya hidup banjir es kopi susu di jakarta	KEUANGAN
tata kelola miliar rupiah dana desa endap	KEUANGAN
infrastruktur tanpa investasi swasta indonesia tinggal	KEUANGAN
langkah bi nilai taktis	KEUANGAN
nila tukar lemah rupiah makin dalam	KEUANGAN
analisis ekonomi tekan fiskal	KEUANGAN
apbn untuk jaga ekspektasi	KEUANGAN
dampak rupiah rembet ke ihsg	KEUANGAN
paja antusiasme wajib pajak tingkat	KEUANGAN
jaga rupiah mesti konsisten	KEUANGAN
nilai tukar rupiah industri farmasi mulai dampak	KEUANGAN
nilai tukar suku bunga jadi solusi jangka pendek	KEUANGAN
korporasi modal saing di tingkat global	KEUANGAN
uang the fed naik suku bunga bi pilih tahan	KEUANGAN
langkah belum cukup hadap gejolak global	KEUANGAN
gaya hidup warteg enggak ada mati	KEUANGAN
nilai tukar perintah mesti gerak cepat	KEUANGAN
duduk desa bisa makin miskin	KEUANGAN
nasib rupiah	KEUANGAN
urban pleidoi cangkir kopi	KEUANGAN
pajak tega hukum segera jalan	KEUANGAN
beras operasi pasar belum dampak signifikan	KEUANGAN
perintah jamin operasi freeport	KEUANGAN
desa optimal potensi ekonomi desa	KEUANGAN
nilai tukar upaya konversi hasil ekspor	KEUANGAN
mandiri ubah mekar di desa	KEUANGAN
analisis ekonomi suku bunga normal	KEUANGAN
analisis ekonomi risiko inflasi semu	KEUANGAN
krisis turki tekan nilai tukar masih bayang	KEUANGAN
nilai tukar mitigasi risiko perlu tingkat	KEUANGAN
analisis ekonomi hela tumbuh	KEUANGAN
nilai tukar tahan ekonomi indonesia sedang uji	KEUANGAN
lingkung sering kalah bencana sebab miskin	LINGKUNGAN
taman nasional komodo nasib saudara tak indah bawah laut jelajah terumbu karang	LINGKUNGAN
transportasi waspada cuaca ekstrem pada libur akhir tahun natal 2017	LINGKUNGAN
citarum makin rusak	LINGKUNGAN
warga citarum siksa hidup di kota dollar	LINGKUNGAN
lingkung hidup dunia lawan sampah plastik	LINGKUNGAN
momentum untuk revitalisasi puncak	LINGKUNGAN
bahaya lubang bekas tambang	LINGKUNGAN
pascatambang abai yang ujung petaka	LINGKUNGAN
danau sembuluh balada arwana tangkap tangan	LINGKUNGAN
kelola lingkung tega hukum buang sampah ke laut lemah	LINGKUNGAN
fenomena alam intensitas bencana mulai tingkat	LINGKUNGAN
polusi plastik ancam	LINGKUNGAN
inovasi warga aneka berkah dari mem sampah	LINGKUNGAN
ubah iklim emil salim rencana masih pikir eksploitasi hutan	LINGKUNGAN
ekosistem makin tak imbang	LINGKUNGAN
cuaca jumlah waduk ering	LINGKUNGAN
rusa sungai citarum biar cemar sejak hulu	LINGKUNGAN
sungai jalan panjang pulih citarum	LINGKUNGAN
kelola laut kaombo lindung laut bongko jelajah terumbu karang	LINGKUNGAN
inisiatif warga namu benteng diri dari tambang	LINGKUNGAN
bencana alam lahan kritis terus tambah	LINGKUNGAN
lepas hutan lahan untuk tebu jadi kebun sawit	LINGKUNGAN
tambang nikel tim menteri segera turun ke sultra	LINGKUNGAN
limbah merkuri perlu terobos prosedur tambang	LINGKUNGAN
rusa lingkung ekosistem leuser dekat hancur	LINGKUNGAN
olah limbah lebaran dengan uang tabung sampah	LINGKUNGAN
waspada cuaca ekstrem macet di jalan tol jakarta-cikampek kembali tingkat - liput lebaran 2017	LINGKUNGAN
cuaca buruk ombak tinggi dompet oleng kapten	LINGKUNGAN
konservasi tngl hutan mitra di gunung leuser	LINGKUNGAN
cemar minyak pertamina evaluasi pipa di balikpapan	LINGKUNGAN
sampah jakarta bekas aju evaluasi kerja sama	LINGKUNGAN
fenomena el nino musim hujan bakal lambat	LINGKUNGAN
langkah produsen nanti	LINGKUNGAN
lindung laut busung lapar yang bangun sadar jelajah terumbu karang	LINGKUNGAN
jelajah terumbu karang dasar laut yang hidup bumi	LINGKUNGAN
tambang nikel warga harap lingkung pulih	LINGKUNGAN
uni geologis misteri air panas bau sulfur di roswar jelajah terumbu karang	LINGKUNGAN
tambang nikel cemar sultra desak rehabilitasi lahan	LINGKUNGAN
cemar lingkung nestapa warga di tanah tambang	LINGKUNGAN
ubah cuaca siklon tropis kai-tak dekat indonesia	LINGKUNGAN
tugas bersih kerja yang sisa usai pesta	LINGKUNGAN
cemar cerita muram muara citarum	LINGKUNGAN
rusa sungai butuh sama tangan citarum	LINGKUNGAN
kering jawa bal dan nusa tenggara defisit air	LINGKUNGAN
musim kemarau jumlah daerah krisis air bersih	LINGKUNGAN
33 situ hilang dalam 10 tahun	LINGKUNGAN
rehabilitasi citarum benah mulai dari cisanti	LINGKUNGAN
cuaca ekstrem siklon kenanga picu gelombang tinggi	LINGKUNGAN
kelola lingkung kapal buang sampah ke laut pelni harus tindak	LINGKUNGAN
cuaca ekstrem kering masih landa	LINGKUNGAN
cop-24 katowice indeks performa ubah iklim indonesia turun	LINGKUNGAN
lingkung dampak mikroplastik perlu teliti serius	LINGKUNGAN
perintah mulai tertib lebur aki	LINGKUNGAN
liput investigasi taruh nyawa di parung panjang	LINGKUNGAN
taman bumi jejak prasasti puluh umur bumi jelajah terumbu karang	LINGKUNGAN
lestari pantai sama jaga mutiara laut jawa	LINGKUNGAN
saat siklon cempaka tumbuh dekat jawa	LINGKUNGAN
eco village benar kami bisa	LINGKUNGAN
konservasi kisah erin potret kejam buru gajah	LINGKUNGAN
cemar laut perlu solusi logam berat dan plastik hancur hidup di pesisir	LINGKUNGAN
merkuri papar juta warga tambang emas skala kecil marak	LINGKUNGAN
tambang kilau yang hancur lumbung pangan kami	LINGKUNGAN
tata sungai kali krukut yang hidup kembali di kalimat jakarta kota sungai	LINGKUNGAN
200 tahun kebun raya bogor semai tumbuh tebar manfaat	LINGKUNGAN
sampah untuk sehat tak ada lagi kisah tragis	LINGKUNGAN
korban limbah merkuri jatuh bayi bisa lahir cacat	LINGKUNGAN
ragam hayati tangkoko benteng rapuh satwa wallacea	LINGKUNGAN
bandar aki bekas peran	LINGKUNGAN
lingkung hidup limbah ancam ekosistem laut utara jakarta	LINGKUNGAN
meteorologi sirkulasi siklonik picu cuaca buruk	LINGKUNGAN
ragam hayati rawat waris alfred wallace	LINGKUNGAN
limbah butuh tindak sama atas cemar laut	LINGKUNGAN
kelola lingkung satu sampah bisa ribu masalah	LINGKUNGAN
risiko bakar tinggi	LINGKUNGAN
kering ancam	LINGKUNGAN
pulih lingkung jadi prioritas	LINGKUNGAN
jelajah terumbu karang hormat pada laut kita ibu kita	LINGKUNGAN
sungai citarum benah mulai tengah januari	LINGKUNGAN
target citarum 2018 gagal	LINGKUNGAN
inisiatif warga harap di ujung sampan	LINGKUNGAN
siklon tropis cuaca ekstrem masih ancam	LINGKUNGAN
dampak merkuri tuhana dan ocih akhir serah	LINGKUNGAN
sampah jakarta jakarta perlu fasilitas olah mandiri	LINGKUNGAN
lebur ilegal daya	LINGKUNGAN
debu timbel cemar warga	LINGKUNGAN
cemar intai warga	LINGKUNGAN
kelola sampah dana insentif untuk baik kerja pemda	LINGKUNGAN
manfaat pilah sampah untuk bayar listrik dan air	LINGKUNGAN
cemar garam dan ikan cemar plastik	LINGKUNGAN
hidup keluarga tiang topang utama	MASALAH SOSIAL
perata jadi prioritas perintah dekat lama ini kritik	MASALAH SOSIAL
rokok parah miskin belanja rokok kalah butuh gizi	MASALAH SOSIAL
hari perempuan internasional perempuan rentan jadi korban keras	MASALAH SOSIAL
ekonomi timpang sejahtera jangan anggap remeh	MASALAH SOSIAL
krisis rakhine dunia dukung langkah indonesia	MASALAH SOSIAL
ri siap bantu banglades pm hasina aku ungsi rohingya jadi beban	MASALAH SOSIAL
krisis rakhine gelombang dua bantu telah tiba	MASALAH SOSIAL
cerai perempuan selalu jadi korban	MASALAH SOSIAL
sehat jiwa gelak tawa bahagia dari bengkel artis	MASALAH SOSIAL
lapor akhir tahun humaniora siap generasi masa depan yang kualitas	MASALAH SOSIAL
warga lanjut usia dukung sosial bagi lansia ubah	MASALAH SOSIAL
sejahtera tani kadin tawar model mitra	MASALAH SOSIAL
kasus ktp elektronik presiden - proses jika cukup bukti	MASALAH SOSIAL
keras polisi minta serius laku usut	MASALAH SOSIAL
hari perempuan internasional keras masih bayang perempuan di tanah air	MASALAH SOSIAL
dana manusia kompas sumbang bagi korban gempa di lombok	MASALAH SOSIAL
dana manusia kompas sumbang untuk korban gempa lombok	MASALAH SOSIAL
dana manusia kompas sumbang untuk korban gempa lombok	MASALAH SOSIAL
dana manusia kompas bantu untuk korban tsunami di selat sunda	MASALAH SOSIAL
ktp-el palsu ancam demokrasi	MASALAH SOSIAL
liput investigasi ironi di lembar ktp elektronik	MASALAH SOSIAL
sejahtera sosial hapus stigma lewat pabrik mebel	MASALAH SOSIAL
dana manusia kompas sumbang korban gempa sulteng	MASALAH SOSIAL
dana manusia kompas sumbang gempa sulteng	MASALAH SOSIAL
dana manusia kompas sumbang gempa sulteng	MASALAH SOSIAL
luas bantu pangan tunda rastra perlu lebih tepat sasar	MASALAH SOSIAL
keras jangan beri ruang aksi persekusi	MASALAH SOSIAL
duduk layan ktp-el belum rata	MASALAH SOSIAL
solidaritas ungsi tradisi ngayah tanpa batas	MASALAH SOSIAL
ktp elektronik jusuf kalla golkar tidak pengaruh	MASALAH SOSIAL
parade perca malang rajut beda jadi karya indah	MASALAH SOSIAL
hari lanjut usia mereka tetap perkasa hingga tua	MASALAH SOSIAL
perintah harus lebih agresif turun angka miskin dan rasio gin langsung lambat	MASALAH SOSIAL
ktp elektronik waktu tunggal data terlalu lama	MASALAH SOSIAL
jelang nikah tugas penting agustin dan srikandi	MASALAH SOSIAL
konflik sosial kuat sama bagai bangsa	MASALAH SOSIAL
nikah kahiyang-bobby adat yang satu kawin	MASALAH SOSIAL
ibu tunggal aku sendiri tetapi aku bahagia	MASALAH SOSIAL
demografi problem duduk tua harus tangan	MASALAH SOSIAL
timpang perintah ubah strategi dan bijak	MASALAH SOSIAL
wawancara khusus menlu tak ada negara yang bisa hidup sendiri	MASALAH SOSIAL
nikah kahiyang-bobby hajat yang teguh bineka	MASALAH SOSIAL
sidang umum pbb ri sodor pandang beda soal krisis rakhine	MASALAH SOSIAL
asean para games sembah juara dari atlet difabel	MASALAH SOSIAL
krisis rakhine ungsi perlu solusi cepat	MASALAH SOSIAL
analisis politik keras agama	MASALAH SOSIAL
inovasi aplikasi tanpa batas di duda timur	MASALAH SOSIAL
dana manusia kompas sumbang untuk korban gempa lombok	MASALAH SOSIAL
dana manusia kompas sumbang untuk korban gempa lombok	MASALAH SOSIAL
dana manusia kompas sumbang bagi korban gempa di lombok	MASALAH SOSIAL
obituari selamat jalan gm sudarta	MASALAH SOSIAL
segera tuntas ktp-el rusak	MASALAH SOSIAL
dana manusia kompas sumbang gempa sulteng	MASALAH SOSIAL
dana manusia kompas sumbang gempa sulteng	MASALAH SOSIAL
dana manusia kompas sumbang gempa sulteng	MASALAH SOSIAL
dana manusia kompas sumbang gempa sulteng	MASALAH SOSIAL
tara perempuan peran dorong ubah	MASALAH SOSIAL
dana manusia kompas sumbang gempa sulteng	MASALAH SOSIAL
semangat mandiri karya atas batas diri	MASALAH SOSIAL
krisis rakhine banglades siap kamp baru	MASALAH SOSIAL
filantropi yuk derma selagi muda	MASALAH SOSIAL
duduk antre panjang 1 km demi ktp-el	MASALAH SOSIAL
nikah kahiyang-bobby berkah dari hajat putri presiden	MASALAH SOSIAL
nikah kahiyang-bobby kawin yang rajut nusantara	MASALAH SOSIAL
ungsi marawi kisah di balik boneka beruang	MASALAH SOSIAL
duduk siap lansia kualitas tak padu	MASALAH SOSIAL
kupi perempuan ulama punya peran besar	MASALAH SOSIAL
miskin laju tanggulang di bawahtarget	MASALAH SOSIAL
bangun turun miskin belum capai target	MASALAH SOSIAL
didik berantas miskin kartu indonesia pintar bagi	MASALAH SOSIAL
perilaku kaum muda prihatin nakal orang tua	MASALAH SOSIAL
krisis rakhine bantu indonesia untuk ungsi rohingya	MASALAH SOSIAL
krisis rakhine suu kyi kecam disinformasi	MASALAH SOSIAL
apbn 2018 program bantu sosial jadi andal	MASALAH SOSIAL
timpang kombinasi program infrastruktur	MASALAH SOSIAL
stephen hawking pikir indah tentang kosmos	MASALAH SOSIAL
tindak keras korban harap umat tidak mudah hasut	MASALAH SOSIAL
amerika serikat juta warga tuntut batas senjata	MASALAH SOSIAL
kasus novel baswedan selesai tak harus lalu jalan tunggal	MASALAH SOSIAL
hari kartini 2018 perempuan teliti kontribusi besar	MASALAH SOSIAL
minum keras oplos mati karena harga murah	MASALAH SOSIAL
miskin kerja ekspor turut kontribusi	MASALAH SOSIAL
bocor blangko ktp-el dorong jahat	MASALAH SOSIAL
dana manusia kompas sumbagan gempa sulteng	MASALAH SOSIAL
dana manusia kompas sumbang gempa sulteng	MASALAH SOSIAL
milenial tentu indonesia emas	MASALAH SOSIAL
keras suporter klub butuh pasti waktu henti liga 1	MASALAH SOSIAL
dana manusia kompas sumbang gempa sulteng	MASALAH SOSIAL
dana manusia kompas sumbang gempa sulteng	MASALAH SOSIAL
dana manusia kompas sumbang gempa sulteng	MASALAH SOSIAL
konflik agraria mereka singkir di tanah sendiri	MASALAH SOSIAL
analisis ekonomi serius urus miskin	MASALAH SOSIAL
bantu alir ke asmat	MASALAH SOSIAL
gera masyarakat giat positif untuk baik nama jabung	MASALAH SOSIAL
daya ibu tabung tak bisa kalah	MASALAH SOSIAL
daerah pencil warga tunggu hadir negara	MASALAH SOSIAL
daya perempuan cara efektif hambat dagang manusia	MASALAH SOSIAL
keras di sekolah menteri didik minta kelahi ajar usut	MASALAH SOSIAL
keras mundur rektor uii apresiasi	MASALAH SOSIAL
dunia didik duka tiga mahasiswa uii tewas telah didik dasar cinta alam	MASALAH SOSIAL
timpang masih lebar korporasi dikte ekonomi	MASALAH SOSIAL
ibarat bumi dan langit	MASALAH SOSIAL
gera sosial cegah mubazir ajak bagi	MASALAH SOSIAL
lindung 28 juta perempuan alami keras	MASALAH SOSIAL
hari anak dunia lindung anak dari pangan tak sehat	MASALAH SOSIAL
miskin di ibu kota kembali bayi yang jual ke dekap ibu	MASALAH SOSIAL
jodoh tolong cari si dia	MASALAH SOSIAL
korban narkoba mereka jerat dan bangkit	MASALAH SOSIAL
serial kejar bahagia dan tangkap	MASALAH SOSIAL
jaring kam kuat semua bantu sosial harus salur nontunai dan padu	MASALAH SOSIAL
krisis rakhine gencat senjata untuk akses bantu	MASALAH SOSIAL
obituari aw subarkah setia sampai akhir	MASALAH SOSIAL
predator anak jaring paedofil leluasa di indonesia	MASALAH SOSIAL
hari kartini jejak kuat perempuan hebat	MASALAH SOSIAL
toleransi harus juang investasi sumber daya manusia sangat penting	MASALAH SOSIAL
indeks bangun manusia senjang turun peringkat indonesia	MASALAH SOSIAL
transmigrasi rawat indonesia mini di tanah harap	MASALAH SOSIAL
sejahtera batas lampu minyak di antara gemerlap batas	MASALAH SOSIAL
miskin hak dasar 11 juta anak ampas	MASALAH SOSIAL
ekspedisi jalur rempah butir pala banda yang satu jalur rempah nusantara	MASALAH SOSIAL
mudik difabel tolak bopong dan tuntun	MASALAH SOSIAL
perempuan teliti karena dia orang perempuan	MASALAH SOSIAL
hari kartini 2018 perempuan teliti bukti tara jender	MASALAH SOSIAL
dana manusia kompas sumbang gempa sulteng	MASALAH SOSIAL
analisis politik likuefaksi negara	MASALAH SOSIAL
nobel damai harga untuk mukwege dan murad	MASALAH SOSIAL
dana manusia kompas sumbang gempa sulteng	MASALAH SOSIAL
jebol sistem aman ktp elektronik	MASALAH SOSIAL
dana manusia kompas sumbang untuk korban gempa lombok	MASALAH SOSIAL
dana manusia kompas sumbang bagi korban gempa di lombok	MASALAH SOSIAL
solidaritas manusia tangan tolong bagi winarni	MASALAH SOSIAL
sejahtera daerah mandiri di balik tumpu sampah	MASALAH SOSIAL
dana manusia kompas bantu untuk korban tsunami di selat sunda	MASALAH SOSIAL
momen kuat solidaritas liput tahun baru 2019	MASALAH SOSIAL
dana manusia kompas bantu untuk korban tsunami di selat sunda	MASALAH SOSIAL
keras suporter tak ada fanatisme padan nyawa	MASALAH SOSIAL
dana manusia kompas sumbang gempa sulteng	MASALAH SOSIAL
masalah sosial misteri kait ning sunarsih dan x12	MASALAH SOSIAL
dana manusia kompas sumbang untuk korban gempa lombok	MASALAH SOSIAL
dana manusia kompas sumbang untuk korban gempa lombok	MASALAH SOSIAL
dana manusia kompas sumbang bagi korban gempa lombok	MASALAH SOSIAL
hari kartini peran perempuan makin penting	MASALAH SOSIAL
kualitas sehat masih rendah	MASALAH SOSIAL
kawin anak cegah belum ke akar soal	MASALAH SOSIAL
narkoba dari candu jadi konselor	MASALAH SOSIAL
keras lima sebar hoaks periksa	MASALAH SOSIAL
kerja manusia kembali manurung kepada masyarakat	MASALAH SOSIAL
dana manusia kompas sumbang gempa sulteng	MASALAH SOSIAL
dana manusia kompas sumbang gempa sulteng	MASALAH SOSIAL
dana manusia kompas sumbang gempa sulteng	MASALAH SOSIAL
dana manusia kompas sumbang gempa sulteng	MASALAH SOSIAL
dana manusia kompas sumbang gempa sulteng	MASALAH SOSIAL
dana manusia kompas sumbang gempa sulteng	MASALAH SOSIAL
dana manusia kompas sumbang gempa sulteng	MASALAH SOSIAL
harga kompas cendekiawan dedikasi 2017 52 tahun kompas	MEDIA MASSA
anti hoax media arus utama harus jadi rujuk	MEDIA MASSA
literasi rendah ladanghoax warga baca berita tak sampai 1 menit	MEDIA MASSA
semangat sama rang hoax	MEDIA MASSA
dekat baru saat terawang masa depan indonesia terawang 2019	MEDIA MASSA
wajah baru kompas 2018	MEDIA MASSA
media besar as lawan trump cnn dan nyt masuk yang cekal	MEDIA MASSA
luncur kompas id tonggak baru hari kompas	MEDIA MASSA
pers tuntut sesuai diri	MEDIA MASSA
realitas internet sikap serius kejam warganet	MEDIA MASSA
harga kompas cendekiawan perang dingin dan perang digital 53 tahun kompas	MEDIA MASSA
pulau anambas bagai ayam sekarat di lumbung sinyal	MEDIA MASSA
bebas pers untuk maju bangsa indonesia jadi contoh	MEDIA MASSA
hari pers nasional kolaborasi media dan teknologi niscaya	MEDIA MASSA
hari pers nasional presiden junjung etika jurnalistik	MEDIA MASSA
hoaks jadi ladang bisnis waspada butuh	MEDIA MASSA
hoax terus tebar benih konflik pakai media sosial dengan baik	MEDIA MASSA
konflik berita bohong itu toreh trauma	MEDIA MASSA
analisis politik teori rekayasa	MEDIA MASSA
20 tahun reformasi makin bebas ekspres makin tak rasional	MEDIA MASSA
jurnalisme wapres media jadi beri tunjuk	MEDIA MASSA
hari pers nasional presiden pers makin butuh sumbar sabana rancak	MEDIA MASSA
lindung anak gawai untuk anak akan batas	MEDIA MASSA
seru di lapang	MEDIA MASSA
cambridge analytica usut	MEDIA MASSA
antar redaksi kolaborasi kompas dan desainer muda	MEDIA MASSA
kolaborasi antara kompas dan generasi milineal	MEDIA MASSA
harga media digital asia kompas id raih piala emas dan perunggu	MEDIA MASSA
dampak konflik marawi jaga pintu gerbang di batas	MILITER
analisis politik internasional timur tengah jalan di tempat	MILITER
krisis al-aqsa warga palestina raya menang	MILITER
iran-as iran makin solid hadap tekan as	MILITER
hari nusantara wujud poros maritim dunia cepat	MILITER
pascateror bom warga satu jaga rumah ibadat	MILITER
satwa latih hitung kuat k-9	MILITER
layar kri bima suci 1 jati diri duta negeri bahari	MILITER
hut ke-72 tni profesionalisme perlu terus juang	MILITER
semenanjung korea korut tuding as pancing perang nuklir	MILITER
krisis mindanao 2 000 warga jebak perang kota di marawi	MILITER
semenanjung korea unjuk kuat militer terus laku	MILITER
krisis mindanao militer upaya rebut marawi	MILITER
komunikasi perintah masih soal bijak jadi bingung	MILITER
damai di afganistan ri dorong temu semua yang tika	MILITER
serang ke suriah alutsista perang dingin aksi lagi	MILITER
krisis palestina-israel konflik di gaza picu tegang diplomatik	MILITER
jordania tuntut adil oki ingat israel krisis al-aqsa bisa picu instabilitas di kawasan	MILITER
mesir gelar operasi militer banyak 305 orang tewas	MILITER
antara tni dan adf	MILITER
tahan presiden dorong sama visi	MILITER
aman jahat dunia maya jadi perhati	MILITER
hidup veteran sekarang saya rasa negara mulai hadir	MILITER
ganti panglima tni baru alutsista jadi prioritas	MILITER
ungsi kimbely singkir dari tanah sendiri	MILITER
ganggu aman bantu untuk warga sandera rampas	MILITER
lapor akhir tahun internasional jaga optimisme di tengah dunia yang gejolak	MILITER
soliditas tni dan polri butuh ambil jarak dengan kuat politik	MILITER
tembak papua 16 jam yang tak lupa	MILITER
bangun trans-papua proyek lanjut pekan depan	MILITER
china-as sanksi picu marah beijing	MILITER
timur tengah pasu darat turki serbu kurdi di suriah	MILITER
krisis marawi tempur sengit terus jadi	MILITER
krisis marawi warga harap konflik segera akhir	MILITER
tahan ksau prioritas baik manajemen	MILITER
ganggu aman atas sandera di mimika upaya persuasif utama	MILITER
tni jangan politik praktis ingat hut tni langsung riah	MILITER
saat jalan tak rekayasa	MILITER
myanmar krisis manusia ancam rohingya	MILITER
krisis al-aqsa aksi lanjut hingga halang cabut	MILITER
palestina-israel indonesia ajak semua pihak tahan diri	MILITER
krisis marawi rawat mitra wujud damai lapor wartawan kompas	MILITER
ktt asean stabilitas aman jadi isu utama	MILITER
as tuai kecam dan dukung	MILITER
palestina pbb periksa insiden di gaza	MILITER
layar bima suci 2 semangat tegak di kapal miring	MILITER
tembak di nduga jenazah 15 kerja telah temu	MILITER
natal dan tahun baru hadir rasa aman di tengah masyarakat liput natal 2018	MILITER
satwa latih k-9 butuh tapi sulit oleh	MILITER
korea utara dunia waswas nanti bukti janji kim jong un	MILITER
aman natal polri waspada teror dan intoleransi natal 2017	MILITER
panglima tni dpr proses cepat calon had	MILITER
tahan had tni hadap tantang kompleks	MILITER
bangun lanjut	MILITER
serba spontan di nduga	MILITER
tenis wimbledon tangis muguruza antar gelar pertama	OLAHRAGA
otomotif nasib rio haryanto dan panggung gemerlap formula 1	OLAHRAGA
australia buka kembali final klasik federer lawan nadal	OLAHRAGA
asean para games 2017 atlet dan latih tetap optimistis	OLAHRAGA
angkat besi jalan lifter cilik ke panggung dunia	OLAHRAGA
piala dunia 2018 putar roda gigi bola rusia 2018	OLAHRAGA
piala dunia 2018 waris soviet yang repot bola rusia 2018	OLAHRAGA
piala dunia 2018 bangun raksasa tidur lapor langsung - bola rusia 2018	OLAHRAGA
lintas sumbawa 320k-2018 mula jalan tembus batas diri kompas tambora challenge	OLAHRAGA
promosi asi games 2018 kontribusi lembaga negara perlu	OLAHRAGA
perempuan daki gunung takluk tujuh puncak dunia	OLAHRAGA
brasil vs kosta rika tim samba paksa tari utama lapor langsung - bola rusia 2018	OLAHRAGA
piala dunia 2018 kolombia selamat nasib jepang bola rusia 2018	OLAHRAGA
piala dunia 2018 bukti tangguh baluarti swedia bola rusia 2018	OLAHRAGA
indonesia siap pesta	OLAHRAGA
harap pada konsistensi asi games kita	OLAHRAGA
semarak asi games galang asa nasionalisme di gbk	OLAHRAGA
inspirasi keping medali asi games kita	OLAHRAGA
tantang di saat akhir	OLAHRAGA
sukarelawan asi games duta bangsa di garis depan	OLAHRAGA
asi games 2018 dki kebut tata gor bulungan	OLAHRAGA
segera benah kurang	OLAHRAGA
borobudur marathon pesona alam yang mikat dunia borobudur marathon 2018	OLAHRAGA
catur samantha edithso curi perhati dunia	OLAHRAGA
tenis jepang terima kasih kepada osaka	OLAHRAGA
asi para games 2018 spirit sama emas pertama inspirasi asia	OLAHRAGA
siap asi games 2018 presiden stadion utama gbk sangat bangga	OLAHRAGA
hobi dan komunitas misi solidaritas di balik ayun langkah kaki	OLAHRAGA
asi games 2018 mudah dana pelatnas ragu	OLAHRAGA
sea games 2017 malaysia cara resmi minta maaf	OLAHRAGA
wimbledon usia bukan halang bagi venus untuk hadap muguruza	OLAHRAGA
perancis buka sensasi si tanpa takut ostapenko di roland garros	OLAHRAGA
lintas sumbawa 2017 drama juang para lari tuju tambora festival pesona tambora 2017	OLAHRAGA
asi games 2018 uji kapasitas inasgoc	OLAHRAGA
asi para games arena tidak ramah atlet difabel	OLAHRAGA
asi games 2018 siap jaran dengan waktu singkat	OLAHRAGA
asi games 2018 jk ini soal waris harga diri bangga	OLAHRAGA
bjbm 2017 jaga harmoni borobudur bank jateng borobudur marathon 2017	OLAHRAGA
asi paragames 2018 perintah jamin dana tidak telat	OLAHRAGA
asi para games 2018 dua masalah besar belum atas	OLAHRAGA
silat minangkabau mambangkik batang tarandam sumbar sabana rancak	OLAHRAGA
taruh citra bangsa	OLAHRAGA
piala dunia 2018 nanti drama sensasional	OLAHRAGA
capai baik belgia bola rusia 2018	OLAHRAGA
analisis politik olahraga jadi muruah negara	OLAHRAGA
atlet siap ukir prestasi tinggi	OLAHRAGA
kalah dengan kepala tegak asi games kita	OLAHRAGA
momen bangkit prestasi asi games kita	OLAHRAGA
asi games 2018 bentuk biasa baru transportasi	OLAHRAGA
piala dunia 2018 griezmann dan hati yang belah bola rusia 2018	OLAHRAGA
akhir dan awal di kazan bola rusia 2018	OLAHRAGA
piala dunia 2018 skuad peru bawa semangat inca di rusia lapor langsung - bola rusia 2018	OLAHRAGA
piala dunia 2018 wajah murung mantan bunuh raksasa - lapor langsung bola rusia 2018	OLAHRAGA
kisah para atlet mereka raya sempat hidup yang dua	OLAHRAGA
pesta para menang hidup	OLAHRAGA
jakarta kizuna ekiden 2018 sama sahabat tuju garis finis	OLAHRAGA
gaya hidup lari tetirah keliling dunia borobudur marathon 2018	OLAHRAGA
electric jakarta marathon 2018 ribu lari juta ekspresi	OLAHRAGA
as buka debut anderson dan nadal yang tiga kali	OLAHRAGA
kualifikasi piala dunia argentina selamat dari zona keras	OLAHRAGA
asi games gerak ekonomi	OLAHRAGA
australia buka roger federer telah kembali	OLAHRAGA
sea games 2017 tata ulang komposisi kontingen indonesia	OLAHRAGA
olahraga fokus manah target bukan salah angin	OLAHRAGA
catur tinggal 0-1 asa irene belum habis	OLAHRAGA
lintas sumbawa 2017 juang mahaberat itu mulai	OLAHRAGA
asi games 2018 ambisi ukir sejarah di rumah sendiri	OLAHRAGA
asi games 2018 drone dan sensasi hitung mundur	OLAHRAGA
tekan pindah pada tiga singa lapor langsung - bola rusia 2018	OLAHRAGA
piala dunia 2018 tuan rumah yang semenjana bola rusia 2018	OLAHRAGA
piala dunia rusia jaga mimpi besar bola rusia 2018	OLAHRAGA
grup e piala dunia 2018 hidup dan mati di stadion spartak lapor langsung - bola rusia 2018	OLAHRAGA
lintas sumbawa 320k-2018 jalur neraka itu uras mental dan tenaga tambora challenge	OLAHRAGA
lintas sumbawa uji nyali di bawah sembilan mentari tambora challenge	OLAHRAGA
tuntas kendala asi games dalam 100 hari	OLAHRAGA
ancam aman tak bisa abai	OLAHRAGA
oase saat kering prestasi	OLAHRAGA
piala dunia 2018 kaki baja kroasia - lapor langsung bola rusia 2018	OLAHRAGA
siap akhir gbk minta fokus untuk asi games 2018	OLAHRAGA
momentum untuk bangkit	OLAHRAGA
selamat pesta	OLAHRAGA
asi games 2018 siap arena kejar waktu	OLAHRAGA
piala dunia 2018 sepak bola dekat kampung halaman lapor langsung - bola rusia 2018	OLAHRAGA
piala dunia 2018 korsel runtuh jaya jerman bola rusia 2018	OLAHRAGA
rusia rangkul warga dunia lapor langsung - bola rusia 2018	OLAHRAGA
piala dunia 2018 angin ubah di lapang merah	OLAHRAGA
piala dunia 2018 moskwa solek sambut pesta bola - lapor langsung bola rusia 2018	OLAHRAGA
piala dunia 2018 juang lawan usang bola rusia 2018	OLAHRAGA
asi para games 2018 alat pelatnas belum bisa beli	OLAHRAGA
semarang 10k tapak lorong sejarah jantung pantai utara jawa	OLAHRAGA
asi games 2018 siapa kita indonesia	OLAHRAGA
indonesia energi asia	OLAHRAGA
panggung agam inspirasi asia	OLAHRAGA
asi para games 2018 jendi sembah emas untuk korban gempa-tsunami inspirasi asia	OLAHRAGA
siap asi games ironi cabang kais anggar	OLAHRAGA
lintas sumbawa 2017 mereka damai dengan kurang diri sendiri festival pesona tambora 2017	OLAHRAGA
lintas sumbawa 2017 duet maut okta-rizki di keras sumbawa festival pesona tambora 2017	OLAHRAGA
wajah lama di sea games 2017 bibit atlet ri kendala	OLAHRAGA
tenis wimbledon kala federer jalan hidup tanpa beban	OLAHRAGA
sea games 2017 rencana program kurang matang	OLAHRAGA
sea games 2017 batas latih tuai protes	OLAHRAGA
sea games 2017 uji coba prima tetap hambat	OLAHRAGA
taruh nama baik indonesia delegasi asi games datang	OLAHRAGA
asi games 2018 cabang olimpiade ancam coret	OLAHRAGA
siap asi games kebut kunjung presiden dewan olimpiade asia jadi ajang negosiasi	OLAHRAGA
bjbm 2017 terbit kembali buah harmoni bank jateng borobudur marathon 2017	OLAHRAGA
asean para games 2017 siap indonesia banyak kendala	OLAHRAGA
kikis habis problem pelatnas malaysia juara sea games 2017 - lapor wartawan kompas kuala lumpur 2017	OLAHRAGA
darurat olahraga indonesia menpora minta maaf atas gagal ri di sea games 2017 - lapor wartawan kompas kuala lumpur 2017	OLAHRAGA
sea games 2017 misi garuda balas malaysia kuala lumpur 2017	OLAHRAGA
sea games 2017 lima emas ri warna aksi gemilang ananda ega - lapor wartawan kompas kuala lumpur 2017	OLAHRAGA
bangkit sama di sea games gambar bendera ri balik coreng buka - kuala lumpur 2017	OLAHRAGA
lintas sumbawa 320k buah dari sabar dan tangguh diri kompas tambora challenge	OLAHRAGA
piala dunia 2018 messi nanti kado indah bola rusia 2018	OLAHRAGA
gaya hidup lari tak lagi murah	OLAHRAGA
kualifikasi piala dunia panser jerman makin dekat ke rusia 2018	OLAHRAGA
asean para games 2017 mereka pulih harkat bangsa	OLAHRAGA
lintas sumbawa 2017 tahun ini saya akan lebih tancap lagi festival pesona tambora 2017	OLAHRAGA
55 tahun tanpa ajar siap asi games 2018 khawatir	OLAHRAGA
wimbledon 2017 antara tradisi dan sentuh modernitas	OLAHRAGA
piala dunia 2018 jerman lawan tulah juara tahan	OLAHRAGA
ajar dari dilema christo tambah 9 emas belum angkat indonesia - lapor wartawan kompas kuala lumpur 2017	OLAHRAGA
atletik bolt yang cinta meski gatlin lampau	OLAHRAGA
piala dunia 2018 pesan satu dari pusat olimpiade rusia lapor langsung - bola rusia 2018	OLAHRAGA
piala dunia 2018 saing di balik kambing jenggot bola rusia 2018	OLAHRAGA
piala dunia 2018 brasil kobar misi raja dunia bola rusia 2018	OLAHRAGA
asa di cabang olimpiade asi games kita	OLAHRAGA
asi games 2018 beri ramah pecah buntu	OLAHRAGA
cetak biru ke level elite	OLAHRAGA
sisi lain asi games di mata para tamu asi games kita	OLAHRAGA
makna sahabat	OLAHRAGA
kirab obor asi games indonesia jaya gema dukung atlet indonesia asi games kita	OLAHRAGA
asi games 2018 terap cetak biru tuju olimpiade	OLAHRAGA
seni budaya serempak entak dunia	OLAHRAGA
piala dunia 2018 negeri rusia juara tanpa trofi lapor langsung - bola rusia 2018	OLAHRAGA
piala dunia 2018 piala dunia dengan rasa piala eropa bola rusia 2018	OLAHRAGA
asi games ke-18 kualitas udara klaim baik	OLAHRAGA
lintas sumbawa 320k tarung para pendekar ultra yang kian ketat tambora challenge	OLAHRAGA
olimpiade musim dingin korsel-korut satu di bawah satu bendera	OLAHRAGA
silat harimau rantau di zaman now	OLAHRAGA
atletik paralimpiade janji tiga sahabat di garis start inspirasi asia	OLAHRAGA
mereka inspirasi kita inspirasi asia	OLAHRAGA
angkat besi juang raih emas olimpiade	OLAHRAGA
semarang 10k dunia usaha nikmat dampak positif semarang 10k	OLAHRAGA
asi games 2018 virus olahraga jangkit generasi milenial	OLAHRAGA
indonesia kalian hebat asi games kita	OLAHRAGA
energi asia pukau dunia asi games kita	OLAHRAGA
asi games 2018 awal bagus di tengah tenggat waktu	OLAHRAGA
satu fokus olimpiade asi games kita	OLAHRAGA
semarak asi games warna-warni yang picu baik	OLAHRAGA
buah manis bina asi games kita	OLAHRAGA
batu loncat ke 2020	OLAHRAGA
partisipasi warga upaya kontingen baik di tengah asi games asi games kita	OLAHRAGA
piala dunia 2018 peluang buah generasi bola rusia 2018	OLAHRAGA
peluang promosi ke dunia	OLAHRAGA
pelatnas asi games sarat masalah tak realistis target medali usul ubah	OLAHRAGA
lapor akhir tahun olahraga nanti prestasi jadi tuan rumah di negeri sendiri	OLAHRAGA
tahun olahraga saat prestasi	OLAHRAGA
asi games 2018 ajar bagi ajang rupa ikut	OLAHRAGA
asi para games 2018 indonesia tatap paralimpiade 2020 inspirasi asia	OLAHRAGA
piala dunia 2018 lahir sprinter bola bola rusia 2018	OLAHRAGA
piala dunia 2018 buah dongeng di musim panas bola rusia 2018	OLAHRAGA
partisipasi perlu genjot	OLAHRAGA
piala dunia 2018 tiga singa dan main ayam cair suasana - lapor langsung bola rusia 2018	OLAHRAGA
les bleus di puncak dunia lapor langsung - bola rusia 2018	OLAHRAGA
ambisius raih 10 besar	OLAHRAGA
asi games 2018 jaga hormat bangsa asi games kita	OLAHRAGA
suporter asi games siap serius laskar semangat	OLAHRAGA
program panjang olimpiade asi games kita	OLAHRAGA
semarak asi games ayo semua mari pesta di gbk	OLAHRAGA
asi games 2018 panjat tebing jaga target tuan rumah asi games kita	OLAHRAGA
pesta olahraga tiket yang buat kecewa tonton asing	OLAHRAGA
awas anggar prestasi olahraga	OLAHRAGA
borobodur marathon para lari elite ketat saing bank jateng brorbudur marathon 2017	OLAHRAGA
piala dunia 2018 les bleus lawan besar kepala lapor langsung - bola rusia 2018	OLAHRAGA
jalan atlet terus lari lalu	OLAHRAGA
uruguay vs perancis roboh benteng la celeste bola rusia 2018	OLAHRAGA
asi para games 2018 david jacobs tak bendung inspirasi asia	OLAHRAGA
borobudur marathon 2018 tantang diri dalam harmoni borobudur marathon 2018	OLAHRAGA
uji nasional bas komputer manfaat teknologi untuk tingkat mutu	PENDIDIKAN
rektor minta cegah radikalisme kuat antarelemen dalam kampus	PENDIDIKAN
giat literasi cahaya cinta dari malang raya	PENDIDIKAN
didik jadi sekolah rumah dua	PENDIDIKAN
joki karya ilmiah kian berani biro jasa skripsi tesis dan disertasi akar dari mentalitas instan	PENDIDIKAN
tenaga didik sertifikasi perlu ikut kembang profesi	PENDIDIKAN
siswa brilian belum kelola	PENDIDIKAN
hidup kiprah olimpian di dunia kerja	PENDIDIKAN
didik prestasi khidmat di jalur profesi guru	PENDIDIKAN
didik siap siswa lawan radikalisme	PENDIDIKAN
anggar untuk tingkat mutu guru	PENDIDIKAN
infrastruktur didik di gudang mereka ajar proklamasi	PENDIDIKAN
didik juru benah vokasi belum optimal	PENDIDIKAN
cabut izin pts mahasiswa pihak yang paling rugi	PENDIDIKAN
semangat abdi ke pelosok demi bayar utang	PENDIDIKAN
didik batas semangat wujud mimpi dari batas negeri	PENDIDIKAN
bijak didik sekolah 5 hari tunggu atur presiden	PENDIDIKAN
unbk lebih akuntabel listrik padam masih jadi kendala utama	PENDIDIKAN
uji nasional semangat kerja sama dan bagi dari unbk	PENDIDIKAN
didik terus gelut dengan masalah klasik	PENDIDIKAN
guru honorer dari kisah periuk nasi hingga batal nikah	PENDIDIKAN
rundung anak luas media sosial disalahgunakan untuk raih aku	PENDIDIKAN
profesi didik ada guru tak peta	PENDIDIKAN
mutu lulus lptk tak pada	PENDIDIKAN
giat mahasiswa kembang pribadi jadi prioritas	PENDIDIKAN
gera mahasiswa tetap kritis walau tidak lagi garang	PENDIDIKAN
didik tinggi ri siap jadi rujuk adab islam dunia	PENDIDIKAN
didik di dalam mimpi anak pulau seram dari balik daun sagu	PENDIDIKAN
rundung sekolah dan keluarga sinergi	PENDIDIKAN
layan didik banyak guru mangkir mutu jadi taruh	PENDIDIKAN
siswa teliti pikir telaten di belantara digital	PENDIDIKAN
didik ulur tangan tepis ironi	PENDIDIKAN
polemik hari sekolah akhir presiden terbit pres	PENDIDIKAN
sarana didik 151 509 ruang kelas sekolah rusak parah	PENDIDIKAN
analisis politik lindung kampus	PENDIDIKAN
kelola sdm sibuk cetak talenta brilian abai kelola	PENDIDIKAN
guru kreatif mereka tak jebak buku teks	PENDIDIKAN
politik identitas jadi indonesia pada zaman now	PENDIDIKAN
bineka indonesia jadi teladan negara lain	PENDIDIKAN
calon guru limpah	PENDIDIKAN
lembaga didik calon guru mahasiswa guru itu di simpang jalan	PENDIDIKAN
didik masih kutat di bawah	PENDIDIKAN
didik belum optimal	PENDIDIKAN
peran guru tak ganti	PENDIDIKAN
ajar sejarah pahlawan monoton	PENDIDIKAN
sekolah hanya tambah dua tenda darurat kita bangkit	PENDIDIKAN
hari didik nasional jalan kaki jemput masa depan	PENDIDIKAN
sekolah terampil prt bekal diri demi dapat kerja layak	PENDIDIKAN
alih kelola sma smk momentum tata sebar guru di tanah air	PENDIDIKAN
curang akademis biro jasa duga libat dosen	PENDIDIKAN
alih kelola sma smk gagap kendala birokrasi-anggaran	PENDIDIKAN
gaji guru kado pahit dan angin surga awal tahun	PENDIDIKAN
uji nasional suara dari pulau pencil	PENDIDIKAN
sma smk alih kelola tidak arti ada sekat	PENDIDIKAN
didik juang keras agar bisa kuliah	PENDIDIKAN
demi sekolah favorit	PENDIDIKAN
rumah singgah al bar oase di terminal kampung rambutan	PENDIDIKAN
didik tengah bangun asa dari gubuk gulita	PENDIDIKAN
juang siswa juta pilu dari malu tenggara barat	PENDIDIKAN
perintah cabut izin 25 pts masyarakat minta cermat pilih guru tinggi	PENDIDIKAN
aktivitas mahasiswa gera kolektif ubah bentuk	PENDIDIKAN
gempa-tsunami sulteng aktivitas didik masih sangat batas kita bangkit	PENDIDIKAN
diskusi kompas vokasi belum selaras dengan dunia industri	PENDIDIKAN
potensi harga naik masih ada upaya stabilisasi terus laku	PERDAGANGAN
akhir polemik beras het bahas lebih lanjut sesuai spesifikasi mutu	PERDAGANGAN
gula tani karut-marut dagang gula	PERDAGANGAN
komoditas pangan beras operasi pasar kurang mati	PERDAGANGAN
daulat pangan konstitusi jamin agam pangan lokal	PERDAGANGAN
trump janji sikap fleksibel	PERDAGANGAN
indonesia siap lawan	PERDAGANGAN
panen harga beras tetap tinggi	PERDAGANGAN
perang dagang bikin cemas	PERDAGANGAN
perang dagang tumbuh ekonomi khawatir koreksi	PERDAGANGAN
pangan operasi pasar beras luas	PERDAGANGAN
festival kopi nusantara bagi demi negeri kopi tetap abadi	PERDAGANGAN
festival kopi nusantara mari sama jaga harta karun	PERDAGANGAN
china alibaba raup rp 145 7 triliun dalam 1 jam	PERDAGANGAN
pangan perintah pasti tak impor beras	PERDAGANGAN
pangan perintah koreksi data beras	PERDAGANGAN
ktt apec china siap pimpin dagang global	PERDAGANGAN
dagang beras tak sehat bongkar produsen eksploitasi konsumen lalu harga	PERDAGANGAN
ekonomi daerah rejowinangun harmoni dari pasar rakyat bank jateng borobudur marathon 2017	PERDAGANGAN
iklim investasi bisa ganggu ekspor konsentrat larang	PERDAGANGAN
dagang harga jual bahan pokok gerak liar	PERDAGANGAN
harga cabai rawit buruk rencana dan transportasi	PERDAGANGAN
garam konsumsi ancam gagal panen semua laku pukul	PERDAGANGAN
pangan perintah gamang tangan beras	PERDAGANGAN
jebak impor pangan	PERDAGANGAN
daulat pangan dalam ancam	PERDAGANGAN
komoditas negosiasi jadi bagi dari strategi	PERDAGANGAN
perang dagang china kecam bijak as	PERDAGANGAN
peduli sosial jalan sunyi juang kopi dalam jelajah kopi nusantara	PERDAGANGAN
beras bulog pacu stok salur tingkat	PERDAGANGAN
keanekaragaman kopi tani robusta lawan stigma jelajah kopi nusantara	PERDAGANGAN
analisis ekonomi mudah usaha	PERDAGANGAN
pangan momentum baik tata niaga beras	PERDAGANGAN
komoditas atas harga mendag pasok cabai sulawesi	PERDAGANGAN
komoditas gula rasa tebu kini tak lagi manis	PERDAGANGAN
tani tebu menperdag tak ada hpp gula	PERDAGANGAN
komoditas cabai naik harga picu banyak faktor	PERDAGANGAN
intervensi pangan perum bulog siap pasok komoditas	PERDAGANGAN
kendali harga beras	PERDAGANGAN
komoditas pangan perintah impor 500 000 ton beras	PERDAGANGAN
komoditas juang tani di republik kopi	PERDAGANGAN
kategori beras segera susun het rp 9 000 per kg tak laku	PERDAGANGAN
butuh masyarakat perintah akhir impor garam dari australia	PERDAGANGAN
ekonomi kreatif angkat gurih kopi amstirdam	PERDAGANGAN
ekspedisi jalur rempah jejak diplomasi lada lintas benua	PERDAGANGAN
teknologi kopi retas dominasi mesin impor jelajah kopi nusantara	PERDAGANGAN
tingkat ekspor jadi solusi	PERDAGANGAN
analisis ekonomi manajemen pangan	PERDAGANGAN
komoditas harga pangan masih di atas acu	PERDAGANGAN
perang dagang sikap trump dan taruh ekonomi amerika serikat	PERDAGANGAN
analisis ekonomi quo vadis impor beras	PERDAGANGAN
riset jadi kunci sukses	PERDAGANGAN
perang dagang as-uni eropa ancam buntu	PERDAGANGAN
lonjak harga telur masalah tak hanya produktivitas ayam	PERDAGANGAN
ekonomi rakyat pkl aset triliun rupiah yang gagap kelola	PERDAGANGAN
dagang perlu serius kendali impor	PERDAGANGAN
operasi pasar beras luas	PERDAGANGAN
beras evaluasi data stok dan produksi	PERDAGANGAN
komoditas stabilisasi harga pangan laku struktur	PERDAGANGAN
butuh pokok perintah klaim spekulan dan harga mulai kendali	PERDAGANGAN
kreativitas kopi puntang pantang mati	PERDAGANGAN
gera sama angkat kopi daya tani	PERDAGANGAN
ekspedisi jalur rempah kiprah juang mutu dari pulau siau jalur rempah nusantara	PERDAGANGAN
garam konsumsi langka harga lonjak 300 persen industri olah ikan ganggu	PERDAGANGAN
usut kartel beras perlu cermat pt ibu bantah manipulasi mutu	PERDAGANGAN
analisis ekonomi langit global kian mendung	PERDAGANGAN
tani tebu mendag tani bebas jual gula	PERDAGANGAN
mudah usaha ekspor-impor tahan laju baik	PERDAGANGAN
dagang perintah intervensi harga pangan lagi	PERDAGANGAN
ekspor-impor cegah defisit makin dalam	PERDAGANGAN
harga pangan pengaruh miskin	PERDAGANGAN
tekan belum reda	PERDAGANGAN
analisis ekonomi di balik perang dagang	PERDAGANGAN
komoditas pangan kemendag minta harga bawang atas	PERDAGANGAN
dagang daring	PERDAGANGAN
perang dagang ekonomi global hadap ketidakpastian	PERDAGANGAN
ekspor mebel perang dagang jadi momentum	PERDAGANGAN
perang dagang asean dan mitra akan lawan proteksionisme	PERDAGANGAN
perang dagang para mitra as siap balas bijak tarif trump	PERDAGANGAN
sekutu as minta dispensasi tarif	PERDAGANGAN
komoditas pangan beras khusus impor untuk operasi pasar	PERDAGANGAN
pusat belanja tangkis senja kala	PERDAGANGAN
pasti stok beras aman dan jangkau data perlu jadi dasar bijak	PERDAGANGAN
pangan surplus beras belum kelola dengan baik	PERDAGANGAN
lembaga legislatif selamat dpd jadi prioritas	POLITIK
milu perancis data kubu macron larang sebar	POLITIK
radikalisme 140 tentara afganistan jadi korban serang	POLITIK
diskusi panel kompas uji daya tahan indonesia	POLITIK
tempur di marawi 38 wni gabung dengan maute	POLITIK
konflik timur tengah qatar siap hadap mungkin buruk	POLITIK
krisis marawi tiga negara sepakat rang terorisme	POLITIK
deklarasi tak cukup tangkal terorisme polri telegram pakai teroris	POLITIK
perintah kami libur sambil kerja	POLITIK
birokrasi awas jadi soal	POLITIK
amerika serikat bijak trump mulai makan korban	POLITIK
pupuk kembali saudara pilkada relatif jalan lancar - cari pimpin 2017	POLITIK
hitung cepat kompas tarung bakal langsung ketat hitung cepat litbang kompas	POLITIK
pilkada dki jakarta putar ii jadwal 19 april	POLITIK
ruu milu fokus pada dampak putus mk	POLITIK
ruu milu dpr dan perintah nilai lengah	POLITIK
perilaku elite keras verbal bisa picu konflik sosial	POLITIK
kode etik dpr mkd kaji surat novanto	POLITIK
milu jerman sulit bagi merkel bentuk koalisi	POLITIK
selamat kerja anies-sandi lantik anies-sandi	POLITIK
lantik gubernur bakso dan nasi kapau gratis di balai kota	POLITIK
imigrasi as kantor panglima tni sudah beri tahu	POLITIK
analisis timur tengah arab saudi usung ideologi baru reformasi	POLITIK
ri jalin langkah tekan trump demo lawan as soal jerusalem mulai rebak	POLITIK
analisis trump jerusalem dan deklarasi perang	POLITIK
ktt luar biasa oki jerusalem timur ibu kota palestina	POLITIK
juang palestina lanjut di mu pbb kaukus arab cari ganti as	POLITIK
lapor akhir tahun muda politik benar kaum muda	POLITIK
analisis politik kuat cinta	POLITIK
menang perempuan isu jender di pilkada bukan masalah rumah pilkada 2018	POLITIK
parpol tampak pragmatis	POLITIK
temu as-korut singapura siap gelar temu sejarah	POLITIK
dasar negara aktualisasi pancasila kunci maju bangsa	POLITIK
20 tahun reformasi tagih ingat kolektif bangsa	POLITIK
intoleransi usut tuntas motif serang dan tegak hukum	POLITIK
damai di afghanistan ri tindak lanjut dengan forum tripartit jakarta	POLITIK
analisis politik berhala demokrasi mantra	POLITIK
survei kompas main waktu jadi strategi 3 5 tahun perintah jokowi-kalla	POLITIK
analisis politik indonesia tahan	POLITIK
pilpres 2019 segala mungkin masih buka	POLITIK
milu malaysia najib-mahathir adu strategi kampanye	POLITIK
milu malaysia saing rambah soal ziarah	POLITIK
20 tahun reformasi kuat budaya warga	POLITIK
milu malaysia warga semangat beri suara	POLITIK
analisis politik sehat demokrasi	POLITIK
kerja sama luar negeri indonesia luas pasar di afrika	POLITIK
jaga suasana tetap tenang	POLITIK
analisis politik tahan sosial	POLITIK
forum tripartit suara damai	POLITIK
milu 2019 elite politik saling uji reaksi	POLITIK
milu 2019 komitmen jaga satu tegas	POLITIK
analisis politik rumit bidik negarawan	POLITIK
milu turki erdogan kembali buru kursi presiden	POLITIK
milu 2019 hasil pilkada jadi timbang rumah pilkada 2018	POLITIK
najib razak segera adil	POLITIK
pilkada 2018 sembilan mohon sengketa daftar ke mk	POLITIK
capres-cawapres formasi tim sukses matang	POLITIK
analisis politik indonesia maju	POLITIK
milu 2019 lembaga politik parpol masih lemah	POLITIK
milu 2019 ganti caleg bekas koruptor	POLITIK
milu kamboja telah juli akhir	POLITIK
indonesia dekat as dan china	POLITIK
perintah presiden jangan goda untuk korupsi	POLITIK
rumah milu wapres kalla media peran penting	POLITIK
milu 2019 joko widodo minta bantu jusuf kalla	POLITIK
ktt g-20 beijing-washington reda tegang	POLITIK
semenanjung korea komitmen korut bagi damai	POLITIK
analisis politik bulan hidup cinta	POLITIK
pemuda penjuru bangsa 90 tahun sumpah pemuda	POLITIK
kiprah kaum muda 90 pemuda jadi sangga bangsa	POLITIK
milu sela as nilai bagi pimpin donald trump	POLITIK
hut ke-70 korut parade riah tanpa pamer rudal	POLITIK
wawancara presiden korea selatan relasi antarmasyarakat penting	POLITIK
anak mantan presiden warna kontestasi	POLITIK
kabinet kerja ombak bagi dari konsolidasi	POLITIK
sidang majelis umum pbb ri dorong pimpin global	POLITIK
milu serentak untung jumlah parpol 4 tahun perintah jokowi-kalla	POLITIK
salah serta tekan jadi kunci survei kompas	POLITIK
diplomasi presiden harap hambat hapus	POLITIK
bagi layan publik as mandek	POLITIK
iran telah aksi rakyat selesai	POLITIK
analisis politik bangsa bukan dadu politik pilkada	POLITIK
kerja sama arab saudi-israel rancang megaproyek timteng	POLITIK
lapor akhir tahun politik-hukum jaga cita sama di tahun politik	POLITIK
aksi bela palestina rakyat indonesia suara tolak tegas ke as	POLITIK
krisis jerusalem ri desak negara lain jangan ikut jejak as	POLITIK
krisis yaman hadir houthi makin colok	POLITIK
krisis lebanon langkah paris buka peluang rekonsiliasi	POLITIK
gubernur dki jakarta anies-sandi siap penuh janji	POLITIK
kerja dpr serang balik ancam parpol pro-angket	POLITIK
krisis rakhine distribusi tunggu lembaga internasional	POLITIK
korut ingin imbang kuat militer dk pbb kecam pyongyang	POLITIK
krisis rakhine puluh ribu warga rohingya usir	POLITIK
laut china selatan vietnam desak asean sikap hadap china	POLITIK
konflik senjata ancam dari palagan di jantung mindanao	POLITIK
babak penting ri-arab saudi pakat biaya proyek nila 7 miliar dollar as	POLITIK
sambut raja salman tegang dan ceria jadi satu	POLITIK
pilkada serentak polri tetap siaga i di banten cari pimpin 2017	POLITIK
negara harus jamin hak pilih warga terobos sedang pikir	POLITIK
menang kotak kosong warga malu tengah tak ingin dinasti politik	POLITIK
kondisi politik perintah segera ambil langkah	POLITIK
jaga bebas serikat laku perppu ormas perlu mekanisme yang jelas dan transparan	POLITIK
ruu milu putus serah kepada paripurna dpr	POLITIK
obama nikmat indonesia beri makna indonesia aman dan kaya budaya	POLITIK
pilih presiden calon tak kualitas potensi muncul	POLITIK
terorisme polisi kembali jadi sasar teror	POLITIK
kpk dpr halang proses hukum polri tidak dapat bantu panitia angket	POLITIK
ancam niis indonesia malaysia dan filipina patroli sama	POLITIK
ri jalin komunikasi dengan qatar bank sentral uea beri sanksi	POLITIK
lembaga bina pancasila bentuk pres telah terbit	POLITIK
krisis mindanao militer filipina ultimatum maute	POLITIK
selesai program sisa cipta suasana sejuk di jakarta	POLITIK
milu perancis macron unggul jadi presiden	POLITIK
semenanjung korea panas aktivitas militer tingkat	POLITIK
perang atau satu	POLITIK
kemelut dpd langkah hukum timbang	POLITIK
istighosah kubro nu jaga nkri jadi harta besar bangsa	POLITIK
teror bom di mesir serang sasar kelompok minoritas	POLITIK
pancasila belum jadi etos elite tidak beri teladan	POLITIK
survei kompas pesan di paruh jabat presiden jokowi	POLITIK
perppu ormas perintah tuntut laksana pancasila	POLITIK
presiden kecewa kuat aparat awas internal perintah	POLITIK
presiden hindar gaduh tensi politik tingkat	POLITIK
spanyol ambil alih catalonia warga madrid tolak separatisme	POLITIK
mesir serang di sai 200 orang tewas	POLITIK
dpd ri malu sidang paripurna langsung ricuh	POLITIK
rombong raja salman tambah beda penting tak jadi halang liput khusus datang raja salman	POLITIK
program deradikalisasi evaluasi seluruh perlu laku	POLITIK
pilkada serentak presiden saat kembali kerja	POLITIK
pilkada 2017 ajar harga dari kabupaten buton cari pimpin 2017	POLITIK
bijak trump usaha optimistis peluang masih buka	POLITIK
amerika serikat barack obama pamit pidato emosional	POLITIK
internasional eropa bisa belok ke kanan	POLITIK
turki perang lawan teror belum selesai	POLITIK
analisis ekonomi akan macron hasil	POLITIK
tindak ganggu satu dunia usaha butuh stabilitas	POLITIK
pesta demokrasi bebas intimidasi negara hadir jaga agam	POLITIK
krisis korea korut siap balas dengan serang nuklir	POLITIK
solidaritas warga ribu lilin untuk jaga satu indonesia	POLITIK
tim independen usul laku dan otak teror hadap kpk tak pernah bisa ungkap	POLITIK
pilkada dki debat pamungkas tak asa panas	POLITIK
novel baswedan teror yang tak padam juang	POLITIK
satu lawan terorisme bom bunuh diri di kampung melayu kait niis	POLITIK
bom bunuh diri rabu akhir tiga bhayangkara muda	POLITIK
rasionalitas evolusi gera teror	POLITIK
rancang format baru bumi pancasila ukp-pip jadi momentum	POLITIK
krisis teluk kuwait pimpin upaya mediasi	POLITIK
demokrasi sandera pragmatisme elite politik strategi perintah tak jelas	POLITIK
krisis suriah perintah lacak ada wni	POLITIK
trump harus satu rakyat para dukung antusias para tentang unjuk rasa	POLITIK
awal di 20 januari	POLITIK
tata kelola bumn harus bebas pengaruh penting	POLITIK
analisis ekonomi elak tanggung jawab nasional	POLITIK
presiden tegas sikap netral masyarakat gerak awal pilkada 2017 cari pimpin	POLITIK
hadir wajah islam moderat raja salman ajak indonesia rang terorisme	POLITIK
kunjung raja salman sukacita pariwisata bal dari sang raja	POLITIK
demokrasi kendali politik identitas	POLITIK
hubung bilateral korsel-indonesia tingkat mitra	POLITIK
ormas agama nu teguh komitmen bangsa	POLITIK
analisis politik budaya politik	POLITIK
wawancara khusus presiden rakyat butuh tenang	POLITIK
krisis spanyol madrid mulai proses cabut otonomi catalonia	POLITIK
tujuh bas nasionalisme dari hati hinggap di toko	POLITIK
gaduh kuras energi bangsa bangun isu publik yang produktif	POLITIK
anggota dpr ancam beku kpk usul di panitia angket makin liar	POLITIK
koordinasi yang kuat untuk atas soal hapus sekat antarinstansi	POLITIK
gedung baru alas dpr sulit terima publik	POLITIK
krisis semenanjung korea korsel-jepang siaga rawan korut siap	POLITIK
timur tengah palestina tolak solusi alternatif dari israel	POLITIK
panitia angket dpr kpk harus awas	POLITIK
selenggara milu putus bawaslu jadi evaluasi kpu	POLITIK
analisis jalan terjal tuju damai afghanistan	POLITIK
diskusi kompas university of melbourne nasionalisme indonesia kini	POLITIK
efektivitas tambah ragu	POLITIK
dpr hambat demokrasi	POLITIK
janggal sejak awal	POLITIK
pilkada 2018 oportunisme politik jadi tantang rumah pilkada 2018	POLITIK
survei kompas sosok lebih dominan di parpol 3 5 tahun perintah jokowi-kalla	POLITIK
temu menlu asean as tegas strategi indo-pasifik	POLITIK
saat negara tegas duka bangsa	POLITIK
dekat lunak pisau mata dua bagi polisi duka bangsa	POLITIK
milu 2019 elite agar jaga suasana kondusif	POLITIK
milu kamboja partai oposisi nyaris tidak milik saksi	POLITIK
pakistan jelang milu bom tewas 132 orang	POLITIK
praktik demokrasi elitis jadi	POLITIK
diskusi kompas oligarki politik kuat	POLITIK
analisis politik menang jiwa tantang	POLITIK
analisis politik asa demokrasi	POLITIK
pilkada 2018 potensi konflik perlu waspada rumah pilkada 2018	POLITIK
temu trump-jong un as optimistis temu hasil	POLITIK
insiden mapolda riau jalan lima menit lama	POLITIK
perintah kaji operasi gabung tragedi manusia	POLITIK
jaring teroris bongkar	POLITIK
teror bom pelihara ukhuwah curabhaya tragedi manusia	POLITIK
bangkit sadar budaya kolektif	POLITIK
pilpres 2019 konsep ekonomi kandidat relatif sama	POLITIK
analisis politik tni antisipasi tirani algoritma	POLITIK
tim kampanye antisipasi potensi simpang	POLITIK
sidang majelis umum pbb ri minta para pimpin satu	POLITIK
profil caleg tak banyak ubah	POLITIK
milu 2019 kampanye damai jadi didik politik	POLITIK
analisis politik ruwat politik	POLITIK
milu sela as demokrat tantang gedung putih	POLITIK
tahun berat bagi trump	POLITIK
as-iran negara upaya kecuali sanksi iran	POLITIK
potensi besar kaum muda kaum 90 tahun sumpah pemuda	POLITIK
tahun 2019 yang tantang indonesia terawang 2019	POLITIK
icmi cendekiawan harap ikut makmur rakyat	POLITIK
brexit may mulai tempur final	POLITIK
bangsa mufakat kembali indonesia	POLITIK
novel baswedan tak sulit ungkap auktor intelektual teror	POLITIK
rusuh bentrok rasisme di as 1 orang tewas	POLITIK
madrid ultimatum catalonia carles puigdemont tangguh deklarasi merdeka	POLITIK
arab saudi laku aksi protes 11 pangeran tahan	POLITIK
analisis politik tahun politik	POLITIK
megaproyek timur tengah palestina dorong tetap juang jerusalem timur	POLITIK
parpol saling tunggu dan intip	POLITIK
dialog bangsa jadi agama sumber nilai	POLITIK
lapor akhir tahun litbang tuju tahun taruh eksistensi partai politik	POLITIK
iran unjuk rasa tentu masa depan rouhani	POLITIK
dialog teras kita dewasa elite politik uji kagama	POLITIK
krisis jerusalem masalah palestina isu manusia	POLITIK
partai golkar usul munaslub segera serah	POLITIK
selenggara milu dpr lanjut seleksi tetapi tanpa jamin	POLITIK
obituari kh hasyim muzadi guru bineka bangsa	POLITIK
kunjung negara sambut penuh untuk raja salman	POLITIK
jaga jujur pilkada hari ini mungut suara gelar serentak di 101 daerah	POLITIK
calon tunggal pilkada juang suara kotak kosong	POLITIK
satu dekade kompas pantau pilkada	POLITIK
timur tengah iran dan turki kirim logistik untuk qatar	POLITIK
tegang perlu segera redam australia sampai minta maaf	POLITIK
politik harus kendali investor mulai tidak nyaman	POLITIK
satu lawan teror presiden jokowi bagi alam ri atas terorisme	POLITIK
pancasila tantang ada di implementasi	POLITIK
krisis mindanao militer filipina gencar serang udara	POLITIK
waspada potensi rembes maute kuat awas batas	POLITIK
ideologi bangsa mereka yang akar pancasila	POLITIK
ktt sabuk dan jalan china ingin hidup jalur sutra baru	POLITIK
jujur parpol uji usul hak angket belum buka	POLITIK
saat pilih sesuai nurani negara jamin hak suara warga	POLITIK
pilkada dki jibaku di baris depan riuh pesta	POLITIK
janggal warna tuju hak angket mahfud tak ada sanksi bagi kpk	POLITIK
temu puncak asean khawatir tegang di korea	POLITIK
kuat indonesia ingat kembali konsensus diri bangsa	POLITIK
bangsa dangdut dan sepak bola yang satu	POLITIK
ancam niis nyata di kawasan asean sandera jadi di australia	POLITIK
krisis diplomatik qatar jalan wni mulai kena dampak	POLITIK
populisme trump	POLITIK
tentara filipina tak beri ruang gerak pagi-petang bom hujan maute	POLITIK
ktt g-20 kerja sama global berantas terorisme pakat	POLITIK
terorisme bom panci ledak di kamar kontra	POLITIK
trump guncang mapan presiden joko widodo optimistis ri-as makin baik	POLITIK
kasn temu janggal jabat daerah duga keluar uang untuk aman posisi	POLITIK
agam jadi kuat pancasila relevan hadap tiap tantang	POLITIK
kampanye usai masa tenang mulai bawaslu waspada giat selubung dan politik uang	POLITIK
perintah daerah batal perda wewenang ma	POLITIK
kerja sama ri-australia presiden jangan takut pilkada	POLITIK
dpd ancam pecah oesman belum sepenuh aku bagai ketua	POLITIK
dpd cacat sejak lahir	POLITIK
seleksi anggota kpu-bawaslu perintah tidak akan obral perppu	POLITIK
partai golkar kosong ketua umum ganggu pilkada	POLITIK
warga dunia protes trump presiden joko widodo galang lobi jelang temu oki	POLITIK
analisis tarung sulit palestina dan arab	POLITIK
konferensi tingkat tinggi asean raih jamin china dalam isu lcs	POLITIK
krisis jerusalem masalah palestina juang di pbb	POLITIK
partai golkar kursi ketua dpr rebut	POLITIK
panitia angket jadi uji partai golkar teguh dukung untuk jokowi pada milu 2019	POLITIK
krisis jerusalem tarung sengit jelang voting mu pbb	POLITIK
pilkada 2018 jumlah partai ubah dukung	POLITIK
peta koalisi mulai baca	POLITIK
lawat negara enam jam presiden indonesia di kabul	POLITIK
tiga tahun jokowi-jk tahun politik bayang kerja	POLITIK
survei kompas jaga momentum di tengah pasang surut 3 tahun perintah jokowi-jk	POLITIK
perintah warga ibu kota yakin pada anies-sandi	POLITIK
separatisme catalonia tegang jelang referendum	POLITIK
jaga ragam jadi harus terus silaturahim antarelite	POLITIK
sikap independen asean uji indonesia dorong konsolidasi - asean 50 2017	POLITIK
sisir duga teroris lanjut tragedi manusia	POLITIK
teror bom polisi dan manusia yang tidak luntur	POLITIK
palestina bentrok kembali jadi di batas israel-gaza	POLITIK
survei kompas pilih gubernur di jawa - tarung di panggung loyalitas	POLITIK
diplomasi indonesia rebut kursi anggota dk pbb	POLITIK
milu turki jelang coblos aman ketat	POLITIK
hasil pilkada pengaruh strategi pilpres	POLITIK
milu malaysia tarung sengit di 37 daerah pilih	POLITIK
pilkada 2024 kompleks rumah pilkada 2018	POLITIK
pilkada 2018 rangkai pilkada yang gembira	POLITIK
evaluasi total rutan teroris	POLITIK
milu malaysia kubu yang saing saling kritik	POLITIK
temu bilateral korsel dan korut pilih main aman	POLITIK
pilih cawapres jadi tentu 3 5 tahun perintah jokowi-kalla	POLITIK
krisis suriah as-sekutu kerah diplomasi di dk pbb	POLITIK
analisis internasional mesir balik kanan	POLITIK
revisi uu md3 dpr bangun imunitas	POLITIK
waspada politik identitas rumah pilkada 2018	POLITIK
damai di afghanistan forum tripartit jadi payung hukum	POLITIK
pimpin mpr kursi tambah untuk penting politik	POLITIK
pilgub di jawa popularitas yang nihil peluang rumah pilkada 2018	POLITIK
forum trilateral ulama ri minta jalan terus meski boikot talib	POLITIK
analisis politik demokrasi degeneratif	POLITIK
cawapres tentu pada saat akhir	POLITIK
koalisi jerman merkel nanti rekor kanselir	POLITIK
kontestasi 2014 bisa ulang	POLITIK
analisis politik kobar asa	POLITIK
milu malaysia sabtu ini polisi dan tentara beri suara	POLITIK
satu untuk indonesia tragedi manusia	POLITIK
ekstrem matang ekosistem teror tragedi manusia	POLITIK
milu kamboja pilih tinggal kota	POLITIK
kontestasi di pileg prediksi kian ketat	POLITIK
milu 2019 polri identifikasi potensi konflik	POLITIK
syarat calon presiden mk ingat untuk cepat putus	POLITIK
analisis politik suci negeri	POLITIK
demokrasi makin matang rumah pilkada 2018	POLITIK
lawan yang kejut	POLITIK
milu turki partai makin gigih untuk mikat warga	POLITIK
cegah aksi teror jadi prioritas	POLITIK
as-korut trump usul lagi temu	POLITIK
analisis politik politik trivialitas	POLITIK
analisis politik sehat beda	POLITIK
temu pimpin dunia ingat abad akhir perang dunia i	POLITIK
presiden ajak anak muda inovasi maju bangsa	POLITIK
konferensi tingkat tinggi sentralitas kuat relevansi asean	POLITIK
kampanye damai jadi komitmen	POLITIK
milu 2019 pragmatisme dorong pindah	POLITIK
analisis politik tahan demokrasi	POLITIK
kerja bukan satu faktor di milu 4 tahun perintah jokowi-kalla	POLITIK
antara kerja dan kontestasi politik	POLITIK
terorisme bom talib renggut 95 jiwa warga sipil	POLITIK
pilkada 2018 tentu pasang di jatim langsung alot	POLITIK
kaukus siap hadap veto amerika serikat langkah alternatif siap	POLITIK
analisis jerusalem oki indonesia jalan masih panjang	POLITIK
indonesia dorong satu negara oki uni eropa tidak akan ikut as	POLITIK
status jerusalem timur tengah panas akibat langkah trump	POLITIK
calon panglima tni had mungkin lantik besok	POLITIK
seluruh elemen tidak boleh lengah dua polantas tuban tembak	POLITIK
tensi di suriah makin panas as lancar serang langsung pertama sejak tahun 2011	POLITIK
bangsa lembaga negara minus negarawan	POLITIK
kejut jumat pagi trump	POLITIK
pilkada dki jakarta jangan mudah hasut kabar sesat	POLITIK
ibu kota tatap era baru	POLITIK
pilkada dki gantung asa di pundak gubernur pilih cari pimpin 2017	POLITIK
survei pasca-pilkada panggung kukuh identitas sosial	POLITIK
parpol laku bunuh diri hari ini hak angket hadap kpk bawa ke rapat paripurna dpr	POLITIK
krisis semenanjung korea tak ada yang mau tahan diri	POLITIK
ibu kota wajah harap bukan tangis galau	POLITIK
milu perancis macron unggul jadi presiden	POLITIK
perintah ambil sikap bubar ormas hti lalu proses hukum	POLITIK
presiden perancis tugas berat nanti emmanuel macron	POLITIK
milu korsel moon siap jalan mandat rakyat	POLITIK
pesan bineka garuda pancasila aku dukung	POLITIK
presiden saya ikut konstitusi pihak yang inkonstitusional akan gebuk	POLITIK
fokus masa depan bangsa momentum satu kembali	POLITIK
bangkit nasional seru dari jantung negeri ayo bangkit	POLITIK
ktt islam-amerika indonesia akan dorong dekat persuasif	POLITIK
dunia kecam teror di inggris bom bunuh diri hantam manchester puluh remaja tinggal	POLITIK
bangsa langkah nyata amat nanti	POLITIK
krisis mindanao tentara filipina kini tingkat serang	POLITIK
terorisme polri kembang lidi ke jabar	POLITIK
rakyat raya pancasila ukp-pip jadi awal yang baik	POLITIK
bangsa nasi bungkus yang topang pancasila	POLITIK
krisis mindanao hadir milisi asing bukti ancam niis	POLITIK
krisis marawi tiga negara patroli di air mindanao	POLITIK
sel niis ada di 16 daerah kondisi marawi filipina pengaruh ke indonesia	POLITIK
krisis teluk indonesia dorong solusi damai	POLITIK
reformasi struktural lanjut hambat tahun politik	POLITIK
krisis qatar harus akhir jakarta terus jalin komunikasi	POLITIK
upaya kuwait temu jalan buntu indonesia beri perhati serius	POLITIK
ukp-pip salah masa lalu jangan ulang	POLITIK
masalah terus ulang dpr-pemerintah gagal ajar	POLITIK
radikalisme dan terorisme blokir demi aman negara	POLITIK
korupsi parpol tetap bisa jadi bantu dari negara naik	POLITIK
pilih dahulu cara cari pimpin	POLITIK
rekrut calon jadi tentu konvensi jadi butuh	POLITIK
debat pilkada dki adu program soal sejahtera warga cari pimpin 2017	POLITIK
debat pun rangsang partisipasi masyarakat nuansa janji masih kuat - cari pimpin 2017	POLITIK
parpol makin pragmatis calon tunggal strategi partai hadap pilkada	POLITIK
transisi pimpin as aksi boikot ancam inaugurasi trump	POLITIK
trump tegas bijak proteksionis demo rebak di mana	POLITIK
hubung bilateral indonesia turut wujud stabilitas kawasan	POLITIK
pidato lantik yang mirip kampanye	POLITIK
jaga kualitas milu 2019 hormat putus mk dan jadwal tahap milu	POLITIK
putus trump lawan wni tak perlu resah perintah sudah antisipasi	POLITIK
pilkada serentak mungut suara ulang tahap cari pimpin 2017	POLITIK
syarat pilih jadi masalah sekitar 71 000 warga dki ancam tak bisa coblos di pilkada	POLITIK
jaga suasana damai pilkada hormat warga yang akan guna hak pilih	POLITIK
survei pilkada dki debat pamungkas jadi tentu	POLITIK
tugas bisa cek absah dokumen 36 lembar ktp palsu selidik	POLITIK
pilkada dki jakarta bagaimana cermat survei politik	POLITIK
pilkada coblos ulang di 2 tps jakarta dan 15 tps banten cari pimpin 2017	POLITIK
hubung korea utara dan malaysia tegang tiga sangka lain masih buru	POLITIK
kunjung negara ri ingin tarik investasi arab saudi	POLITIK
bangsa kerja elite tentu kualitas demokrasi	POLITIK
libur raja arab saudi bal pilih karena indah laut liput khusus datang raja salman	POLITIK
temu tokoh jokowi dan yudhoyono tepis ketidakpercayaan	POLITIK
teror di london laku pernah libat kasus keras	POLITIK
partai golkar syarat munaslub penuh	POLITIK
demokrasi taruh putus mk selenggara milu bukan dari partai	POLITIK
milu dan pilkada mesin partai mulai gerak	POLITIK
ri-korsel pacu industrialisasi mitra jadi basis cepat ekonomi	POLITIK
hari pahlawan cari makna pahlawan pada zaman	POLITIK
teror di new york trump akan ketat seleksi imigran	POLITIK
indonesia minta klarifikasi cabut larang hadap gatot tak cukup	POLITIK
putus trump tuai kecam kubu garis keras di iran bisa oleh angin segar	POLITIK
krisis rakhine bantu indonesia sesuai butuh	POLITIK
krisis rakhine misi manusia ditindaklanjuti	POLITIK
pesan warga ri sampai indonesia percaya ikut beri bantu di rakhine	POLITIK
rakyat indonesia pesta hut ke-72 republik indonesia	POLITIK
hari merdeka pesan sirat lewat pakai adat	POLITIK
bangsa terima beda fondasi satu	POLITIK
teror di spanyol laku siap serang lebih besar	POLITIK
krisis venezuela maduro abai sanksi oposisi tangkap	POLITIK
australia polisi tangkap empat rencana teror	POLITIK
mk tentu lanjut ruu selenggara milu tuju jadi undang	POLITIK
arab saudi drama kudeta putih di istana al-safa	POLITIK
timpang otonomi untung bisnis besar	POLITIK
pimpin mpr wakil rakyat makin jarak dari rakyat	POLITIK
milu presiden mesir warga ikan suara dengan jaga ketat di tps-tps	POLITIK
analisis politik dua dekade reformasi	POLITIK
pimpin mpr susun uu md3 tak cermat	POLITIK
nu rawat budaya jaga bangsa	POLITIK
sikap rasional pilih tunggu rumah pilkada 2018	POLITIK
milu turki kuasa baru di tangan erdogan	POLITIK
analisis politik gema orkestra pancasila	POLITIK
perppu ormas guna bubar hizbut tahrir indonesia uji di adil	POLITIK
bangun timpang buruk sejak otda	POLITIK
ruu milu tarung prediksi ketat	POLITIK
as jangkau rudal korut korsel cepat tempat sistem antirudal thaad dari as	POLITIK
bantu bagi warga rakhine tunda menag ri hormat hak warga	POLITIK
pilpres ulang di kenya presiden kecam ma cemas muncul	POLITIK
sidang umum pbb ri punya modal kuat di dewan aman	POLITIK
pimpin ibukota negara	POLITIK
anies ajak jakarta satu siap asi games 2018 nanti tuntas - lantik anies-sandi	POLITIK
filipina selatan konflik di marawi masuk fase akhir	POLITIK
ganggu aman sedia pangan warga sandera tip	POLITIK
golkar tarik novanto dari dpr posisi ketua dpr jadi incar	POLITIK
pilkada 2018 tiga provinsi amat tentu	POLITIK
ma-dpd main hukum oesman sapta jadi ketua dpd	POLITIK
calon anggota kpu-bawaslu dpr potensi langgar uu	POLITIK
ktt i iora acu maju kawasan pakat	POLITIK
jaga rasa aman warga siap pilkada 2017 capai 95 persen - cari pimpin 2017	POLITIK
13 023 saksi tidak cukup	POLITIK
bijak trump naik risiko negara mitra harus antisipasi dini	POLITIK
analisis globalisme g-20 yang salah arah	POLITIK
filipina marawi kota indah di mindanao yang koyak	POLITIK
dpr ancam kpk dan polri tito jangan korban aman	POLITIK
terorisme dunia kecam serang teror di london	POLITIK
qatar hendak dialog indonesia sedia bantu selesai masalah	POLITIK
qatar sejak lama jadi oposisi	POLITIK
saat jawab tantang adil dan satu jadi soal	POLITIK
bangsa mereka kerja di akar rumput	POLITIK
ktt arab islam amerika mitra tumpu untuk lawan terorisme	POLITIK
gubernur jakarta pilih janji adil sosial bagi semua warga	POLITIK
langkah awal rekonsiliasi mulai menang harus rangkul semua	POLITIK
diplomasi pence tepis ragu asean	POLITIK
di balik kunjung mike pence	POLITIK
negara jaga pilkada dki damai jenis surat terang yang resmi dan aku tempel di tps - cari pimpin 2017	POLITIK
pansus angket kpk pkb dan pks tak akan kirim anggota	POLITIK
rakyat tunggu langkah nyata tegas presiden apresiasi	POLITIK
pansus angket kpk fraksi pks resmi tak akan kirim anggota	POLITIK
terorisme kapolri jaring jad sudah tahu	POLITIK
donald trump dan tatanan dunia baru	POLITIK
timur tengah krisis kira buruk	POLITIK
ruu milu penting bangsa harus dahulu	POLITIK
perintah tertib ormas perppu nomor 2 tahun 2017 nilai abai asas demokrasi	POLITIK
jelang lantik dunia nanti pidato trump	POLITIK
pilkada 2017 jemput pilih yang belum daftar	POLITIK
perintah jamin pilkada aman hari ini kampanye akhir cari pimpin 2017	POLITIK
pilkada dki jakarta banyak polisi tidak usah takut pak	POLITIK
korea selatan akibat teman park jungkal	POLITIK
lapor akhir tahun metropolitan cukup jakarta saja jangan yang lain lapor akhir tahun	POLITIK
bijak amerika serikat menlu tillerson ancam copot	POLITIK
densus tipikor bisa timbul gaduh kalla tak perlu ada tim berantas korupsi baru	POLITIK
polemik pidato sebut pribumi kurang bijaksana	POLITIK
tantang besar gubernur baru bangun tepat sasar karena partisipasi publik tinggi	POLITIK
asean hadap terorisme indonesia dorong tradisi konsolidasi - asean 50 2017	POLITIK
hati hadap israel alat pindai metal di kompleks al-aqsa ganti kamera siluman canggih	POLITIK
terorisme samping beda politik	POLITIK
tafsir liar libat tni cegah	POLITIK
analisis internasional lonceng mati solusi dua negara	POLITIK
gera sosial satu lawan terorisme	POLITIK
selenggara milu tujuh anggota kpu langgar kode etik	POLITIK
analisis politik raih bahagia	POLITIK
buka babak baru as dan korut	POLITIK
tantang di depan kim jong un	POLITIK
analisis politik panas yang dingin	POLITIK
gagal pilkada tawar legislatif	POLITIK
analisis politik raya merdeka	POLITIK
dana otonomi khusus dana besar tidak banding hasil	POLITIK
analisis politik kocak k otak kosong	POLITIK
milu 2019 parpol ganti caleg bekas napi korupsi	POLITIK
presiden jaga aset besar	POLITIK
milu malaysia umno pecat dua tokoh senior yang belot	POLITIK
dukung untuk presiden syarat	POLITIK
bangun manusia jadi fokus 4 tahun perintah jokowi-kalla	POLITIK
milu 2019 efektivitas demokrasi mesti jaga	POLITIK
sidang majelis umum pbb hari buka warna kritik trump	POLITIK
milu legislatif partai tetap aju calon bekas koruptor	POLITIK
analisis politik presiden pimpin	POLITIK
milu legislatif putus ma punya potensi cacat formil	POLITIK
analisis politik cetak politis gagas	POLITIK
pasti hak pilih warga	POLITIK
mufakat budaya pancasila jadi satu bangsa	POLITIK
brexit uni eropa tuju inggris keluar	POLITIK
analisis politik indonesia gagah	POLITIK
analisis politik milu integritas	POLITIK
korupsi di birokrasi kepala daerah pegang peran penting	POLITIK
semua pihak saling tunggu	POLITIK
semua kandidat dorong milu damai	POLITIK
pangan perintah akan gelontor beras	POLITIK
analisis politik lomba lambat adu siasat analisis politik	POLITIK
identitas nusantara tonjol	POLITIK
terorisme program cegah perlu komitmen sama	POLITIK
jarusalem indonesia terus galang dukung	POLITIK
zimbabwe mantan wapres ganti mugabe	POLITIK
tarung ketat di jawa	POLITIK
krisis jerusalem dunia arab raya menang diplomasi palestina	POLITIK
ikci 2018 ukur cerdas kota di indonesia	POLITIK
analisis politik pesona peluk indonesia	POLITIK
komitmen parpol uji	POLITIK
masalah ekonomi jadi prioritas	POLITIK
timur tengah al qaeda ancam putra mahkota arab saudi	POLITIK
milu turki erdogan hadap lawan ketat	POLITIK
bom pasuruan jaring lama rancang aksi baru	POLITIK
tangguh demokrasi lokal uji rumah pilkada 2018	POLITIK
pks minta temu sama	POLITIK
analisis politik tunggu capres-cawapres	POLITIK
dinamika akhir jadi tentu	POLITIK
kabinet kena dampak	POLITIK
milu 2019 jokowi-prabowo terus jaga silaturahim	POLITIK
titik balik tangan terorisme	POLITIK
forum trilateral babak baru di afghanistan mulai	POLITIK
pilpres 2019 ulama di ppp aju rekomendasi	POLITIK
negara jamin aman	POLITIK
malaysia anwar ibrahim segera bebas dan terjun ke politik	POLITIK
analisis politik daya lenting demokrasi	POLITIK
analisis politik politik adab	POLITIK
analisis politik hilang indonesia	POLITIK
tegang diplomatik kremlin kami pasti balas	POLITIK
milu 2019 lanjut temu jokowi dengan politis	POLITIK
hut gerindra prabowo siap maju kembali di pilpres	POLITIK
lobi politik makin intensif	POLITIK
milu 2019 jusuf kalla saya ikut konstitusi	POLITIK
saing partai politik makin ketat	POLITIK
skandal rusia di pilpres as selidik dakwa 13 orang rusia	POLITIK
analisis politik jahat benci	POLITIK
verifikasi faktual selenggara milu bahas jumlah opsi	POLITIK
lapor akhir tahun nusantara damba pilkada serentak dengan santun politik	POLITIK
yaman sniper tewas mantan presiden	POLITIK
as-israel pojok di majelis umum pbb 128 negara dukung resolusi	POLITIK
presiden pilih pimpin baik	POLITIK
analisis iran tidak mudah pecah telur	POLITIK
pilkada 2018 azwar anas kabar mundur	POLITIK
sekutu as kecam putus trump palestina harga sikap indonesia	POLITIK
anak muda jaga indonesia mudaindonesia	POLITIK
singapura peran satu presiden halimah	POLITIK
terorisme ancam residivis makin nyata	POLITIK
aman lawan teror kami spontan kejar	POLITIK
jokowi bangun optimisme 4 tahun perintah jokowi-kalla	POLITIK
mufakat budaya agam jadi modal sosial rajut saling erti	POLITIK
analisis politik bohong politik	POLITIK
milu 2019 program populis untuk rebut suara	POLITIK
konferensi tingkat tinggi asean dorong tegas soal rohingya	POLITIK
pahlawan nasional indonesia rumah sama	POLITIK
analisis politik cemburu dan rindu kampanye mutu	POLITIK
bangsa jadi pancasila pijak sama	POLITIK
draf brexit akan pakat	POLITIK
analisis politik politik martabat	POLITIK
hut bogor raya rasa dan asa dari presiden dan rakyat	PROFIL
indeks kota cerdas indonesia 2018 manfaat teknologi untuk sejahtera warga ikci 2018	PROFIL
batas jadi tantang bangun infrastruktur saja belum cukup	PROFIL
desa isolasi serasa maut begitu dekat dengan mereka	PROFIL
infrastruktur saja tak cukup bangun sumber daya manusia butuh di batas - jelajah tapal batas	PROFIL
gambar soal pahlawan ubah	PROFIL
tradisi budaya ketika 5 035 putri solo tari	SENI
tradisi pesan damai nasi kembar	SENI
harry-meghan ketika tradisi inggris temu budaya afrika-amerika	SENI
ruang publik pesta ala betawi pengantin jepang di kampung padat	SENI
kuliner rajut rasa di lebaran china	SENI
ruwat gunung tebar dan tanam baik	SENI
evaluasi lebaran rencana matang buah baik liput lebaran 2017	SENI
hari batik nasional batik jokowi belum gusur dari thamrin city	SENI
manajemen pangan sangat tentu naik harga ulang	SENI
arus mudik lebaran kapolri prediksi lalu lintas lancar	SENI
siap mudik cikunir jadi hambat pertama	SENI
idul fitri 1438 h momentum kuat satu	SENI
tradisi lebaran di dusun adat kampung kuta dan aboge	SENI
karakter baik semai semangat toleransi di sekolah	SENI
imlek toleransi di lereng kawi	SENI
festival internasional janji abadi kisah panji	SENI
raya imlek tabuhan damai dari penagi	SENI
gelar patung gwk rampung seniman gelar syukur	SENI
umat pupuk bineka	SENI
pandu presiden pramuka wadah kreativitas generasi milenial	SENI
kain jalur tenun di tanah marapu	SENI
lestari lingkung tahan ibu akhir	SENI
ramadhan di papua nine wa makiat mari bakar batu liput lebaran 2017	SENI
jaga cagar budaya dari sekadar hobi jadi militan dan kreatif	SENI
konservasi tak henti rangkai puzzle borobudur borobudur marathon 2018	SENI
tata kota nikmat wajah baru cihampelas	SENI
kreativitas ruang dunia kecil dinding baja	SENI
kampung warna cat tembok tata mental	SENI
kreativitas warga kampung 3d yang ubah wajah kota	SENI
fenomena kampung inggris pare takluk bahasa dunia dari kampung	SENI
literasi peperangan anak rawa belum usai	SENI
bahasa ibu 11 bahasa daerah sudah punah	SENI
jamu cerpen kompas regenerasi tulis sastra kini laju	SENI
komunitas geliat sastra kota malang	SENI
cendekiawan dedikasi 2017 tak pernah jemu suara jujur dan adil	SENI
bahasa indonesia serap dari bahasa daerah galak	SENI
malam jamu cerpen kompas kisah yang bebas	SENI
didik revolusi bahasa dari borobudur bank jateng brorbudur marathon 2017	SENI
buku anak agar si bocah gemar baca	SENI
indonesia titi pentas buku dunia	SENI
film baik ffi 2017 night bus tentang negeri dan konflik	SENI
kreator muda agam yang bangga bangsa	SENI
hari pahlawan kenal pahlawan dengan cara kreatif	SENI
film horor cabik sensasi ngeri	SENI
piala oscar 2018 hollywood raya ragam	SENI
film kejar latar ke luar negeri	SENI
drama korea kiblat imajinasi dua	SENI
film republik layar tancap	SENI
film pendek energi besar di kancah global	SENI
film komunitas jadi motor gerak	SENI
festival film cannes titip indonesia kepada para sineas	SENI
makau film judi dan taruh	SENI
industri film layar kembang di makassarwood	SENI
industri film film daerah muncul	SENI
pasca-orde baru wajah film kian majemuk	SENI
golden globe serba hitam dari dunia hibur	SENI
anak muda gerilya lewat karya	SENI
festival fotografi kompas kisah yang lewat di panggung kertas	SENI
gaya hidup buru cantik tingkat dewa	SENI
muda indonesia generasi milenial tentu arah	SENI
lomba lari bjbm potensi kembang	SENI
borobudur marathon yuk lari biar enggak edan bank jateng borobudur marathon 2017	SENI
gaya hidup erat solidaritas dari tamasya	SENI
gaya hidup libur yang asyik dan produktif	SENI
ragam indonesia beda yang hadir bahagia	SENI
gaya hidup libur di sini saja	SENI
gaya hidup tolong aku ini masih hewan	SENI
gaya hidup libur akhir tahun saat selfito ergo sum tahun baru 2018	SENI
raya tahun baru warna 2018 dengan damai dan rukun tahun baru 2018	SENI
fenomena hingga keringat cucur dan bedak luntur	SENI
stand up hutan 2018 tertawa sama tanpa saling stigma	SENI
bineka sebar damai di atas papan main	SENI
hidup ikat adat di pulau padat	SENI
identitas budaya tetap bangga bahasa daerah di era global	SENI
seren taun keping surga dari cigugur	SENI
pidato budaya merdeka sejati mulia manusia	SENI
cap go meh pesta multietnis antero ri	SENI
rumah gadang tunggu kembali rumah ibu sumbar sabana rancak	SENI
budaya kalimantan buru dan ramu kini di ambang akhir	SENI
alat musik nusantara kisah para jaga denting sape ekspedisi alat musik nusantara 2018	SENI
ranah mang surau tradisi yang lahir tokoh nasional sumbar sabana rancak	SENI
budaya nusantara filsafat wayang kaya dunia	SENI
susun strategi budaya lemah kohesi sosial tak cukup atas dengan bijak ekonomi	SENI
kongres budaya bebas ekspresi budaya jadi kunci jaga bineka	SENI
transisi budaya kisah pemburu-peramu akhir kalimantan	SENI
kongres budaya perlu panggung interaksi yang toleran	SENI
kontes cantik di balik mimpi putri cantik	SENI
fenomena waris tren gigi ala madura	SENI
kuliner betawi rumah dodol akhir di serpong	SENI
cita rasa nusantara nasi kapau raja kuliner minangkabau sumbar sabana rancak	SENI
inovasi kuliner mulia ragam pangan lokal	SENI
festival kuliner makan jalan adalah leluhur	SENI
tradisi minum kopi revolusi mulai dari kedai kopi jelajah kopi nusantara	SENI
tani gunung kelir rintis kedai kopi di tengah kampung	SENI
gaya hidup kopi tak punya kasta	SENI
pangan lokal makin karisma	SENI
kuliner masakan kampung tenteram hati	SENI
seni rupa jendela lihat indonesia	SENI
kartun gurat manusia	SENI
lukis rakyat industri pandang dari desa	SENI
kreativitas kota sama di tengah beda	SENI
50 tahun oom pasikom seni cubit dengan senyum	SENI
fenomena maaf kami belum bisa move on	SENI
diskusi hari kompas musik nusantara jadi rekat bangsa	SENI
geliat dangdut kami sadar buat dosa	SENI
alat musik nusantara tara pada bilah kolintang ekspedisi alat musik nusantara 2018	SENI
gel bal dari tihingan ke penjuru dunia ekspedisi alat musik nusantara 2018	SENI
gondang batak nyanyi hidup lirih sarune ekspedisi alat musik nusantara 2018	SENI
gitaris peduli negeri gerak nada untuk bantu sama	SENI
konser longok kotak kaca nostalgia	SENI
musik indah simfoni adab	SENI
musik ketika rock tak sekadar naik panggung	SENI
arab saudi dari konservatisme ke konser musik	SENI
alat musik nusantara denting sunyi sang pedambus ekspedisi alat musik nusantara 2018	SENI
musik demam piring hitam rem cepat digital	SENI
dendang kencana rasa musik itu pun tumbuh sejak dini	SENI
ode bulan agustus nyanyi sama puji negeri	SENI
hidup musisi nasib tragis cipta lagu poco-poco	SENI
industri musik jalan panjang lagu anak	SENI
lingkung hidup krakatau dan segar wangi hutan	SENI
musik puitik lirik untuk hati yang cabik	SENI
jazz wisata pelangi di atas telaga	SENI
hidup hibur rakyat dangdut gerobak	SENI
tradisi gamelan lintas abbey road	SENI
gamelan tempa baik hidup eskpedisi alat musik nusantara 2018	SENI
konser peduli negeri dari gitaris untuk rakyat	SENI
seni mang guru mulia talempong ekspedisi alat musik nusantara 2018	SENI
gaya hidup eksotika lokal yang global	SENI
musik kala semesta warna jazz	SENI
sasandu lontar adalah susu ekspedisi alat musik nusantara 2018	SENI
kendara listrik pihak pada industri nasional uji	SENI
kendara listrik hilir riset butuh pihak	SENI
pamer otomotif dunia mobil hantu segera gentayang	SENI
otomotif gerilya wujud kendara listrik nasional	SENI
ekonomi kreatif pahat batu mena hidup borobudur marathon 2018	SENI
infrastruktur titi jalur neraka pantura flores jelajah sepeda flores	SENI
madu sumbawa buru dan bagi sarang lebah hutan festival pesona tambora 2017	SENI
jelajah kopi nusantara juta kisah dari pelosok negeri jelajah kopi nusantara	SENI
jalan sepeda moles manikam di jantung jawa kompas bike jateng gayeng	SENI
jateng bike kayuh ironi jauh 336 kilometer kompas bike jateng gayeng	SENI
gera literasi sebar virus baca	SENI
hibur warga kisah pasar malam naik kelas	SENI
libur raja salman istana raja di tanah dewata	SENI
relasi sosial nama juga seni ya bebas	SENI
seni tradisi jalan panjang sang sinden	SENI
seni kontemporer hong kong dalam kemas estetik	SENI
borobudur marathon sapa lari dengan seni borobudur marathon 2018	SENI
seni cerita manis saat gerimis	SENI
art jakarta 2018 seni dalam jangkau kantong	SENI
bentara budaya setia abdi pada seni pinggir	SENI
artjog buru para seniman	SENI
festival fulan fehan likurai raya tenun	SENI
tunjuk opera cinta indonesia di rumah susun	SENI
teater melodrama kaum pinggir	SENI
hari pahlawan doa untuk pahlawan tanpa nama	SENI
kerja jalan tol siang-malam cor	TENAGA KERJA
kiprah tki dari mancanegara bangun desa	TENAGA KERJA
perempuan kerja rumah mereka harus juang hanya untuk rp 1 000	TENAGA KERJA
tenaga kerja indonesia desa dorong proaktif lindung tki	TENAGA KERJA
celaka infrastruktur bpk bisa laku audit investigasi	TENAGA KERJA
prioritas selamat	TENAGA KERJA
tenaga asing jadi sorot	TENAGA KERJA
pegawai tenaga honorer tak dapat thr	TENAGA KERJA
kerja migran ajar daya di tanah rantau	TENAGA KERJA
eksploitasi tki sejak buat paspor	TENAGA KERJA
ketenagakerjaan upah minimum provinsi masih tunggu	TENAGA KERJA
kualitas kerja jadi tantang	TENAGA KERJA
ump 2018 umum gubernur hari ini bahas masih langsung	TENAGA KERJA
mutu sdm jadi hambat sertifikasi dan akreditasi tenaga kerja belum optimal	TENAGA KERJA
jumlah profesi ancam hilang cerdas buat belum masuk kurikulum pt	TENAGA KERJA
tenaga kerja indonesia malaysia razia kerja tanpa izin	TENAGA KERJA
buku inspirasi bangun daya kreatif anak dari desa lamuk	TENAGA KERJA
daya saing-produktivitas balai latih kerja desak benah	TENAGA KERJA
disrupsi digital tenaga kerja industri besar pangkas	TENAGA KERJA
generasi milenial bonus demografi si doyan pindah	TENAGA KERJA
banyak anak muda anggur digital buat lebih fleksibel	TENAGA KERJA
kerja di tinggi geliat terobos langit dan tantang maut	TENAGA KERJA
lindung tki jalan panjang pulang nurkoyah	TENAGA KERJA
proses rumit giring tki pada calo	TENAGA KERJA
ketenagakerjaan sekitar 7 juta orang anggur	TENAGA KERJA
pegawai tenaga honorer angkat jadi pegawai	TENAGA KERJA
ketenagakerjaan gubernur wajib umum upah	TENAGA KERJA
hari buruh karyawan freeport mogok kerja	TENAGA KERJA
upah minimum relokasi usaha jadi pilih laku industri	TENAGA KERJA
upah buruh siasat hemat demi sambung hidup	TENAGA KERJA
daya kisah mereka yang tolak gagal	TENAGA KERJA
urban dag-dig-dug kerja tinggi	TENAGA KERJA
tunjang hari raya rp 35 76 triliun untuk tunjang	TENAGA KERJA
ketenagakerjaan kembang belum maksimal	TENAGA KERJA
selamat kerja 8 kerja tewas dan 4 lain hilang	TENAGA KERJA
tenaga kerja asing indonesia usaha baik daya saing	TENAGA KERJA
tenaga kerja indonesia parinah 18 tahun tak bisa pulang	TENAGA KERJA
analisis ekonomi insiden infrastruktur	TENAGA KERJA
ketenagakerjaan produktivitas untuk optimal upah	TENAGA KERJA
hut korpri asn lebih tanggap dan buka	TENAGA KERJA
